accessorize=accessorise
accessorized=accessorised
accessorizes=accessorises
accessorizing=accessorising
acclimatization=acclimatisation
acclimatization's=acclimatisation's
acclimatize=acclimatise
acclimatized=acclimatised
acclimatizes=acclimatises
acclimatizing=acclimatising
accouter=accoutre
accoutered=accoutred
accoutering=accoutring
accouterments=accoutrements
accouters=accoutres
accurst=accursed
acknowledgment=acknowledgement
acknowledgment's=acknowledgement's
acknowledgments=acknowledgements
actualization=actualisation
actualization's=actualisation's
actualize=actualise
actualized=actualised
actualizes=actualises
actualizing=actualising
adz=adze
adz's=adze's
aggrandize=aggrandise
aggrandized=aggrandised
aggrandizement=aggrandisement
aggrandizement's=aggrandisement's
aggrandizes=aggrandises
aggrandizing=aggrandising
agonize=agonise
agonized=agonised
agonizes=agonises
agonizing=agonising
agonizingly=agonisingly
airfoil=aerofoil
airfoil's=aerofoil's
airfoils=aerofoils
airplane=aeroplane
airplane's=aeroplane's
airplanes=aeroplanes
aline=align
alined=aligned
alinement=alignement
alinement's=alignement's
alinements=alignements
alines=alignes
alining=aligning
alkalize=alkalise
alkalized=alkalised
alkalizes=alkalises
alkalizing=alkalising
almanac=almanack
almanacs=almanacks
alphabetization=alphabetisation
alphabetization's=alphabetisation's
alphabetizations=alphabetisations
alphabetize=alphabetise
alphabetized=alphabetised
alphabetizer=alphabetiser
alphabetizer's=alphabetiser's
alphabetizers=alphabetisers
alphabetizes=alphabetises
alphabetizing=alphabetising
altho=although
aluminum=aluminium
aluminum's=aluminium's
ameba=amoeba
amebae=amoebae
ameba's=amoeba's
amebas=amoebas
amebic=amoebic
ameboid=amoeboid
Americanization=Americanisation
Americanization's=Americanisation's
Americanizations=Americanisations
Americanize=Americanise
Americanized=Americanised
Americanizes=Americanises
Americanizing=Americanising
amortizable=amortisable
amortization=amortisation
amortization's=amortisation's
amortizations=amortisations
amortize=amortise
amortized=amortised
amortizes=amortises
amortizing=amortising
amphitheater=amphitheatre
amphitheater's=amphitheatre's
amphitheaters=amphitheatres
analogize=analogise
analogized=analogised
analogizes=analogises
analogizing=analogising
analyzable=analysable
analyze=analyse
analyzed=analysed
analyzer=analyser
analyzer's=analyser's
analyzers=analysers
analyzes=analyses
analyzing=analysing
anathematize=anathematise
anathematized=anathematised
anathematizes=anathematises
anathematizing=anathematising
anatomize=anatomise
anatomized=anatomised
anatomizes=anatomises
anatomizing=anatomising
anemia=aenemia
anemia's=aenemia's
anemic=aenemic
anemically=aenemically
anesthesia=anaesthesia
anesthesia's=anaesthesia's
anesthesiologist=anaesthesiologist
anesthesiologist's=anaesthesiologist's
anesthesiologists=anaesthesiologists
anesthesiology=anaesthesiology
anesthesiology's=anaesthesiology's
anesthetic=anaesthetic
anesthetic's=anaesthetic's
anesthetics=anaesthetics
anesthetist=anaesthetist
anesthetist's=anaesthetist's
anesthetists=anaesthetists
anesthetization=anaesthetization
anesthetization's=anaesthetization's
anesthetize=anaesthetize
anesthetized=anaesthetized
anesthetizes=anaesthetizes
anesthetizing=anaesthetizing
anglicize=anglicise
anglicized=anglicised
anglicizes=anglicises
anglicizing=anglicising
annualized=annualised
annuled=annulled
annuling=annulling
anodize=anodise
anodized=anodised
anodizes=anodises
anodizing=anodising
antagonize=antagonise
antagonized=antagonised
antagonizes=antagonises
antagonizing=antagonising
anthologize=anthologise
anthologized=anthologised
anthologizes=anthologises
anthologizing=anthologising
anthropomorphize=anthropomorphise
antilabor=antilabour
apologize=apologise
apologized=apologised
apologizes=apologises
apologizing=apologising
apostatize=apostatise
apostatized=apostatised
apostatizes=apostatises
apostatizing=apostatising
appareled=apparelled
appareling=apparelling
appetizer=appetiser
appetizer's=appetiser's
appetizers=appetisers
appetizing=appetising
appetizingly=appetisingly
arbor=arbour
arbor's=arbour's
arbors=arbours
archeological=archeaological
archeologist=archeaologist
archeologist's=archeaologist's
archeologists=archeaologists
archeology=archeaology
archeology's=archeaology's
ardor=ardour
ardor's=ardour's
ardors=ardours
armor=armour
armored=armoured
armorer=armourer
armorer's=armourer's
armorers=armourers
armories=armouries
armoring=armouring
armor's=armour's
armors=armours
armory=armoury
armory's=armoury's
artifact=artefact
artifact's=artefact's
artifacts=artefacts
ascendency=ascendancy
ascendency's=ascendancy's
ass=arse
ass'=arse's
asshole=arsehole
asshole's=arsehole's
assholes=arseholes
ass's=arse's
atomize=atomise
atomized=atomised
atomizer=atomiser
atomizer's=atomiser's
atomizers=atomisers
atomizes=atomises
atomizing=atomising
attitudinize=attitudinise
attitudinized=attitudinised
attitudinizes=attitudinises
attitudinizing=attitudinising
authorization=authorisation
authorization's=authorisation's
authorizations=authorisations
authorize=authorise
authorized=authorised
authorizes=authorises
authorizing=authorising
automatize=automatise
automatized=automatised
automatizes=automatises
automatizing=automatising
ax=axe
ax's=axe's
backpedaled=backpedalled
backpedaling=backpedalling
balk=baulk
balked=baulked
balking=baulking
balk's=baulk's
balks=baulks
baptize=baptise
baptized=baptised
baptizer=baptiser
baptizer's=baptiser's
baptizers=baptisers
baptizes=baptises
baptizing=baptising
barbarize=barbarise
barbarized=barbarised
barbarizes=barbarises
barbarizing=barbarising
barreled=barrelled
barreling=barrelling
bastardization=bastardisation
bastardization's=bastardisation's
bastardizations=bastardisations
bastardize=bastardise
bastardized=bastardised
bastardizes=bastardises
bastardizing=bastardising
battleax=battleaxe
battleax's=battleaxe's
bedeviled=bedevilled
bedeviling=bedevilling
behavioral=behavioural
behaviorally=behaviourally
behavior=behaviour
behaviorism=behaviourism
behaviorism's=behaviourism's
behaviorist=behaviourist
behaviorist's=behaviourist's
behaviorists=behaviourists
behavior's=behaviour's
behaviors=behaviours
behoove=behove
behooved=behoved
behooves=behoves
behooving=behoving
bejeweled=bejewelled
bejeweling=bejewelling
belabor=belabour
belabored=belaboured
belaboring=belabouring
belabors=belabours
Beria=Baeria
Beria's=Baeria's
beveled=bevelled
beveling=bevelling
Beyer=Baeyer
Beyer's=Baeyer's
binging=binging
blamable=blameable
bowdlerization=bowdlerisation
bowdlerization's=bowdlerisation's
bowdlerizations=bowdlerisations
bowdlerize=bowdlerise
bowdlerized=bowdlerised
bowdlerizes=bowdlerises
bowdlerizing=bowdlerising
bowlder=bowldre
bowlder's=bowldre's
bowlders=bowldres
breathalyze=breathalyse
breathalyzed=breathalysed
breathalyzer=breathalyser
breathalyzers=breathalysers
breathalyzes=breathalyses
breathalyzing=breathalysing
brutalization=brutalisation
brutalization's=brutalisation's
brutalize=brutalise
brutalized=brutalised
brutalizes=brutalises
brutalizing=brutalising
bureaucratization=bureaucratisation
bureaucratization's=bureaucratisation's
bureaucratize=bureaucratise
bureaucratized=bureaucratised
bureaucratizes=bureaucratises
bureaucratizing=bureaucratising
burglarize=burglarise
burglarized=burglarised
burglarizes=burglarises
burglarizing=burglarising
busheled=bushelled
busheling=bushelling
caliber=calibre
caliber's=calibre's
calibers=calibres
calk=caulk
calked=caulked
calking=caulking
calking's=caulking's
calkings=caulkings
calk's=caulk's
calks=caulks
canalization=canalisation
canalization's=canalisation's
canalize=canalise
canalized=canalised
canalizes=canalises
canalizing=canalising
cancelation=cancellation
canceled=cancelled
canceler=canceller
canceler's=canceller's
cancelers=cancellers
canceling=cancelling
candor=candour
candor's=candour's
cannibalization=cannibalisation
cannibalization's=cannibalisation's
cannibalize=cannibalise
cannibalized=cannibalised
cannibalizes=cannibalises
cannibalizing=cannibalising
canonization=canonisation
canonization's=canonisation's
canonizations=canonisations
canonize=canonise
canonized=canonised
canonizes=canonises
canonizing=canonising
cantaloup=cantaloupe
cantaloup's=cantaloupe's
cantaloups=cantaloupes
capitalization=capitalisation
capitalization's=capitalisation's
capitalize=capitalise
capitalized=capitalised
capitalizes=capitalises
capitalizing=capitalising
capsulize=capsulise
capsulized=capsulised
capsulizes=capsulises
capsulizing=capsulising
caramelize=caramelise
caramelized=caramelised
caramelizes=caramelises
caramelizing=caramelising
carbonize=carbonise
carbonized=carbonised
carbonizes=carbonises
carbonizing=carbonising
cardie=cardiae
caroled=carolled
caroler=caroller
caroler's=caroller's
carolers=carollers
caroling=carolling
catalog=catalogue
cataloged=catalogued
cataloger=cataloguer
cataloger's=cataloguer's
catalogers=cataloguers
cataloging=catalogues
catalog's=catalogue's
catalogs=cataloguing
catalyze=catalyse
catalyzed=catalysed
catalyzes=catalyses
catalyzing=catalysing
catechize=catechise
catechized=catechised
catechizes=catechises
catechizing=catechising
categorization=categorisation
categorization's=categorisation's
categorizations=categorisations
categorize=categorise
categorized=categorised
categorizes=categorises
categorizing=categorising
catheterize=catheterise
catheterized=catheterised
catheterizes=catheterises
catheterizing=catheterising
cauterization=cauterisation
cauterization's=cauterisation's
cauterize=cauterise
cauterized=cauterised
cauterizes=cauterises
cauterizing=cauterising
caviled=cavilled
caviler=caviller
caviler's=caviller's
cavilers=cavillers
caviling=cavilling
cavilings=cavillings
cenobite=coenobite
cenobite's=coenobite's
cenobites=coenobites
cenobitic=coenobitic
centerboard=centreboard
centerboard's=centreboard's
centerboards=centreboards
center=centre
centered=centred
centerfold=centrefold
centerfold's=centrefold's
centerfolds=centrefolds
centering=centrepiece
centering=centring
centerpiece=centrepiece's
centerpiece's=centrepieces
centerpieces=centres
center's=centre's
centers=centres
centigram=centigramme
centigram's=centigramme's
centigrams=centigrammes
centiliter=centilitre
centiliter's=centilitre's
centiliters=centilitres
centimeter=centimetre
centimeter's=centimetre's
centimeters=centimetres
centralization=centralisation
centralization's=centralisation's
centralize=centralise
centralized=centralised
centralizer=centraliser
centralizer's=centraliser's
centralizers=centralisers
centralizes=centralises
centralizing=centralising
cesium=caesium
cesium's=caesium's
channeled=channelled
channeling=channelling
channelization=channelisation
channelization's=channelisation's
channelize=channelise
channelized=channelised
channelizes=channelises
channelizing=channelising
characterization=characterisation
characterization's=characterisation's
characterizations=characterisations
characterize=characterise
characterized=characterised
characterizes=characterises
characterizing=characterising
checkbook=chequebook
checkbook's=chequebook's
checkbooks=chequebooks
checkerboard=chequeerboard
checkerboard's=chequeerboard's
checkerboards=chequeerboards
checkered=chequeered
checkering=chequeering
chili=chilli
chilies=chillies
chili's=chilli's
chilis=chillis
chiseled=chiselled
chiseler=chiseller
chiseler's=chiseller's
chiselers=chisellers
chiseling=chiselling
Christianize=Christianise
cigaret=cigarette
cigaret's=cigarette's
cigarets=cigarettes
circularize=circularise
circularized=circularised
circularizes=circularises
circularizing=circularising
civilization=civilisation
civilization's=civilisation's
civilizations=civilisations
civilize=civilise
civilized=civilised
civilizes=civilises
civilizing=civilising
clamor=clamour
clamored=clamoured
clamoring=clamouring
clamor's=clamour's
clamors=clamours
clangor=clangour
clangor's=clangour's
clarinetist=clarinettist
clarinetist's=clarinettist's
clarinetists=clarinettists
cognizable=cognisable
cognizance=cognisance
cognizance's=cognisance's
cognizant=cognisant
collateralize=collateralise
collectivization=collectivisation
collectivization's=collectivisation's
collectivize=collectivise
collectivized=collectivised
collectivizes=collectivises
collectivizing=collectivising
colonization=colonisation
colonization's=colonisation's
colonize=colonise
colonized=colonised
colonizer=coloniser
colonizer's=coloniser's
colonizers=colonisers
colonizes=colonises
colonizing=colonising
colorant=colourant
colorant's=colourant's
colorants=colourants
coloration=colouration
coloration's=colouration's
colorblind=colourblind
colorblindness=colourblindness
colorblindness's=colourblindness's
color=colour
colored=coloured
colored's=coloured's
coloreds=coloureds
colorfast=colourfast
colorfastness=colourfastness
colorfastness's=colourfastness's
colorful=colourful
colorfully=colourfully
colorfulness=colourfulness
colorfulness's=colourfulness's
coloring=colouring
coloring's=colouring's
colorist=colourisation
colorists=colourisation's
colorization=colourise
colorization's=colourised
colorize=colourises
colorized=colourising
colorizes=colourist
colorizing=colourists
colorless=colourless
colorlessly=colourlessly
colorlessness=colourlessness
colorlessness's=colourlessness's
color's=colour's
colors=colours
colorway=colourway
colorways=colourways
commercialization=commercialisation
commercialization's=commercialisation's
commercialize=commercialise
commercialized=commercialised
commercializes=commercialises
commercializing=commercialising
compartmentalization=compartmentalisation
compartmentalization's=compartmentalisation's
compartmentalize=compartmentalise
compartmentalized=compartmentalised
compartmentalizes=compartmentalises
compartmentalizing=compartmentalising
compeled=compelled
compeling=compelling
comptroler=comptroller
computerization=computerisation
computerization's=computerisation's
computerize=computerise
computerized=computerised
computerizes=computerises
computerizing=computerising
conceptualization=conceptualisation
conceptualization's=conceptualisation's
conceptualizations=conceptualisations
conceptualize=conceptualise
conceptualized=conceptualised
conceptualizes=conceptualises
conceptualizing=conceptualising
concertize=concertise
concertized=concertised
concertizes=concertises
concertizing=concertising
connecter=connectre
connecter's=connectre's
connecters=connectres
connectible=connectable
connection=connexion
connection's=connexion's
connections=connexions
containerization=containerisation
containerization's=containerisation's
containerize=containerise
containerized=containerised
containerizes=containerises
containerizing=containerising
contextualization=contextualisation
contextualize=contextualise
contextualized=contextualised
contextualizes=contextualises
contextualizing=contextualising
controled=controlled
controler=controller
controler's=controller's
controling=controlling
conventionalize=conventionalise
conventionalized=conventionalised
conventionalizes=conventionalises
conventionalizing=conventionalising
cooky=kooky
cooky's=kooky's
corraled=corralled
corraling=corralling
councilor=councillor
councilor's=councillor's
councilors=councillors
counseled=counselled
counseling=counselling
counselor=counsellor
counselor's=counsellor's
counselors=counsellors
cozier=cosier
cozies=cosies
coziest=cosiest
cozily=cosily
coziness=cosiness
coziness's=cosiness's
cozy=cosy
cozy's=cosy's
criminalize=criminalise
criminalized=criminalised
criminalizes=criminalises
criminalizing=criminalising
criticize=criticise
criticized=criticised
criticizer=criticiser
criticizer's=criticiser's
criticizers=criticisers
criticizes=criticises
criticizing=criticising
crueler=crueller
cruelest=cruellest
cruely=cruelly
crystalize=crystallise
crystalized=crystallised
crystalizes=crystallises
crystalizing=crystallising
crystallization=crystallisation
crystallization's=crystallisation's
crystallize=crystallise
crystallized=crystallised
crystallizes=crystallises
crystallizing=crystallising
cudgeled=cudgelled
cudgeling=cudgelling
cudgelings=cudgellings
curbed=kerbed
curbing=kerbing
curb=kerb
curb's=kerb's
curbs=kerbs
customization=customisation
customization's=customisation's
customize=customise
customized=customised
customizes=customises
customizing=customising
decentralization=decentralisation
decentralization's=decentralisation's
decentralized=decentralised
decentralize=decentralise
decentralizes=decentralises
decentralizing=decentralising
deciliter=decilitre
deciliter's=decilitre's
deciliters=decilitres
decimalization=decimalisation
decimeter=decimetre
decimeter's=decimetre's
decimeters=decimetres
decolonization=decolonisation
decolonization's=decolonisation's
decolonized=decolonised
decolonize=decolonise
decolonizes=decolonises
decolonizing=decolonising
decontroled=decontrolled
decontroling=decontrolling
decriminalization=decriminalisation
decriminalization's=decriminalisation's
decriminalized=decriminalised
decriminalize=decriminalise
decriminalizes=decriminalises
decriminalizing=decriminalising
defensed=defenced
defense=defence
defenseless=defenceless
defenselessly=defencelessly
defenselessness=defencelessness
defenselessness's=defencelessness's
defense's=defence's
defenses=defences
defensing=defencing
dehumanization=dehumanisation
dehumanization's=dehumanisation's
dehumanized=dehumanised
dehumanize=dehumanise
dehumanizes=dehumanises
dehumanizing=dehumanising
demagnetization=demagnetisation
demagnetization's=demagnetisation's
demagnetized=demagnetised
demagnetize=demagnetise
demagnetizes=demagnetises
demagnetizing=demagnetising
demagog=demagogue
demagogry=demagoguery
demagog's=demagogue's
demagogs=demagogues
demeanor=demeanour
demeanor's=demeanour's
demilitarization=demilitarisation
demilitarization's=demilitarisation's
demilitarized=demilitarised
demilitarize=demilitarise
demilitarizes=demilitarises
demilitarizing=demilitarising
demobilization=demobilisation
demobilization's=demobilisation's
demobilized=demobilised
demobilize=demobilise
demobilizes=demobilises
demobilizing=demobilising
democratization=democratisation
democratization's=democratisation's
democratized=democratised
democratize=democratise
democratizes=democratises
democratizing=democratising
demonetization=demonetisation
demonetization's=demonetisation's
demonetized=demonetised
demonetize=demonetise
demonetizes=demonetises
demonetizing=demonetising
demonized=demonised
demonize=demonise
demonizes=demonises
demonizing=demonising
demoralization=demoralisation
demoralization's=demoralisation's
demoralized=demoralised
demoralize=demoralise
demoralizes=demoralises
demoralizing=demoralising
denationalization=denationalisation
denationalized=denationalised
denationalize=denationalise
denationalizes=denationalises
denationalizing=denationalising
dentin=dentine
dentin's=dentine's
denuclearized=denuclearised
denuclearize=denuclearise
denuclearizes=denuclearises
denuclearizing=denuclearising
deodorization=deodorisation
deodorization's=deodorisation's
deodorized=deodorised
deodorize=deodorise
deodorizer=deodoriser
deodorizer's=deodoriser's
deodorizers=deodorisers
deodorizes=deodorises
deodorizing=deodorising
departmentalization=departmentalisation
departmentalization's=departmentalisation's
departmentalized=departmentalised
departmentalize=departmentalise
departmentalizes=departmentalises
departmentalizing=departmentalising
dependance=dependence
dependance's=dependence's
depersonalized=depersonalised
depersonalize=depersonalise
depersonalizes=depersonalises
depersonalizing=depersonalising
depolarization=depolarisation
depolarization's=depolarisation's
depolarized=depolarised
depolarize=depolarise
depolarizes=depolarises
depolarizing=depolarising
depoliticized=depoliticised
depoliticize=depoliticise
depoliticizes=depoliticises
depoliticizing=depoliticising
depressurization=depressurisation
depressurized=depressurised
depressurize=depressurise
depressurizes=depressurises
depressurizing=depressurising
deprogram=deprogramme
deprogramed=deprogrammeed
deprograms=deprogrammes
deputized=deputised
deputize=deputise
deputizes=deputises
deputizing=deputising
desalinization=desalinisation
desalinization's=desalinisation's
desalinized=desalinised
desalinize=desalinise
desalinizes=desalinises
desalinizing=desalinising
descendent's=descendant's
descendents=descendants
desensitization=desensitisation
desensitization's=desensitisation's
desensitized=desensitised
desensitize=desensitise
desensitizes=desensitises
desensitizing=desensitising
destabilization=destabilisation
destabilized=destabillised
destabilize=destabillise
destabilizes=destabillizes
destabilizing=destabillizing
deviled=devilled
deviling=devilling
devitalized=devitalised
devitalize=devitalise
devitalizes=devitalises
devitalizing=devitalising
dialed=dialled
dialing=dialling
dialings=diallings
dialog's=dialogue's
dialogs=dialogues
dialyzes=dialyses
diarrhea=diarroea
diarrhea's=diarrhoea's
digitization=digitisation
digitized=digitised
digitize=digitise
digitizes=digitises
digitizing=digitising
discoloration=discolouration
discoloration's=discolouration's
discolorations=discolourations
discolor=discolour
discolored=discoloured
discoloring=discolouring
discolors=discolours
disemboweled=disembowelled
disemboweling=disembowelling
disfavor=disfavour
disfavored=disfavoured
disfavoring=disfavouring
disfavor's=disfavour's
disfavors=disfavours
disheveled=dishevelled
disheveling=dishevelling
dishonorable=dishonourable
dishonorably=dishonourably
dishonor=dishonour
dishonored=dishonoured
dishonoring=dishonouring
dishonor's=dishonour's
dishonors=dishonours
disorganization=disorganisation
disorganization's=disorganisation's
disorganized=disorganised
disorganize=disorganise
disorganizes=disorganises
disorganizing=disorganising
distill=distil
distills=distils
dolor=dolour
dolor's=dolour's
donut=doughnut
donut's=doughnut's
donuts=doughnuts
doweled=dowelled
doweling=dowelling
downdraft=downdraught
downdraft's=downdraught's
draft=draught
draftier=draughtier
draftiest=draughtiest
draftily=draughtily
draftiness=draughtiness
draftiness's=draughtiness's
draft's=draught's
drafts=draughts
draftsman=draughtsman
draftsman's=draughtsman's
draftsmanship=draughtsmanship
draftsmanship's=draughtsmanship's
draftsmen=draughtsmen
draftswoman=draughtswoman
draftswoman's=draughtswoman's
draftswomen=draughtswomen
drafty=draughty
dramatization=dramatisation
dramatization's=dramatisation's
dramatizations=dramatisations
dramatized=dramatised
dramatize=dramatise
dramatizes=dramatises
dramatizing=dramatising
dreamed=dreamt
driveled=drivelled
driveler=driveller
driveler's=driveller's
drivelers=drivellers
driveling=drivelling
dueled=duelled
dueler=dueller
dueler's=dueller's
duelers=duellers
dueling=duelling
duelings=duellings
duelist=duellist
duelist's=duellist's
duelists=duellists
ecolog=ecologue
ecolog's=ecologue's
ecologs=ecologues
economized=economised
economize=economise
economizer=economiser
economizer's=economiser's
economizers=economisers
economizes=economises
economizing=economising
ecus=oecus
edema=oedema
edema's=oedema's
edemas=oedemas
editorialized=editorialised
editorialize=editorialise
editorializes=editorialises
editorializing=editorialising
egis=aegis
egis's=aegis's
elasticized=elasticised
elasticize=elasticise
elasticizes=elasticises
elasticizing=elasticising
embolization=embolisation
emotionalized=emotionalised
emotionalize=emotionalise
emotionalizes=emotionalises
emotionalizing=emotionalising
empaneled=empanelled
empaneling=empanelling
empathized=empathised
empathize=empathise
empathizes=empathises
empathizing=empathising
emphasized=emphasised
emphasize=emphasise
emphasizes=emphasises
emphasizing=emphasising
employe=employee
employe's=employee's
employes=employees
enameled=enamelled
enameler=enameller
enameler's=enameller's
enamelers=enamellers
enameling=enamelling
enamelings=enamellings
enamored=enamoured
enamor=enamour
enamoring=enamouring
enamors=enamours
endeavored=endeavoured
endeavor=endeavour
endeavoring=endeavouring
endeavor's=endeavour's
endeavors=endeavours
energized=energised
energize=energise
energizer=energiser
energizer's=energiser's
energizers=energisers
energizes=energises
energizing=energising
enroll=enrol
enrollment=enrolment
enrollment's=enrolment's
enrollments=enrolments
enrolls=enrols
enthrall=enthral
enthrallment=enthralment
enthrallment's=enthralment's
enthralls=entrals
epaulet=epaulette
epaulet's=epaulette's
epaulets=epaulettes
epicenter=epicentre
epicenter's=epicentre's
epicenters=epicentres
epilog=epilogue
epilog's=epilogue's
epilogs=epilogues
epitomized=epitomised
epitomize=epitomise
epitomizes=epitomises
epitomizing=epitomising
equaled=equalled
equaling=equalling
equalization=equalisation
equalization's=equalisation's
equalized=equalised
equalize=equalise
equalizer=equaliser
equalizer's=equaliser's
equalizers=equalisers
equalizes=equalises
equalizing=equalising
esophagi=oesophagi
esophaguses=oesophaguses
esthete=aesthete
esthete's=aesthete's
esthetes=aesthetes
esthetic=oesophagi
esthetics=oesophaguses
estrogen=oestrogen
estrogen's=oestrogen's
estrous=oestrous
estruses=oestruses
estrus=oestrus
estrus's=oestrus's
etiology=aetiology
etiology's=aetiology's
eulogized=eulogised
eulogize=eulogise
eulogizer=eulogiser
eulogizer's=eulogiser's
eulogizers=eulogisers
eulogizes=eulogises
eulogizing=eulogising
evangelized=evangelised
evangelize=evangelise
evangelizes=evangelises
evangelizing=evangelising
eviler=eviller
evilest=evillest
exceled=excelled
exceling=excelling
exorcized=exorcised
exorcize=exorcise
exorcizes=exorcises
exorcizing=exorcising
expeled=expelled
expeling=expelling
extemporization=extemporisation
extemporization's=extemporisation's
extemporized=extemporised
extemporize=extemporise
extemporizes=extemporises
extemporizing=extemporising
externalization=externalisation
externalization's=externalisation's
externalizations=externalisations
externalized=externalised
externalize=externalise
externalizes=externalises
externalizing=externalising
extoled=extolled
extoling=extolling
extoll=extol
extolls=extols
factorization=factorisation
factorized=factorised
factorize=factorise
factorizes=factorises
factorizing=factorising
fair=fayre
familiarization=familiarisation
familiarization's=familiarisation's
familiarized=familiarised
familiarize=familiarise
familiarizes=familiarises
familiarizing=familiarising
fantasized=fantasised
fantasize=fantasise
fantasizes=fantasises
fantasizing=fantasising
favorable=favourable
favorably=favourably
favored=favoured
favor=favour
favoring=favouring
favorite=favourite
favorite's=favourite's
favorites=favourites
favoritism=favouritism
favoritism's=favouritism's
favor's=favour's
favors=favours
fecal=faecal
feces=faeces
feces's=faeces's
federalization=federalisation
federalization's=federalisation's
federalized=federalised
federalize=federalise
federalizes=federalises
federalizing=federalising
feminized=feminised
feminize=feminise
feminizes=feminises
feminizing=feminising
fertilization=fertilisation
fertilization's=fertilisation's
fertilized=fertilised
fertilize=fertilise
fertilizer=fertiliser
fertilizer's=fertiliser's
fertilizers=fertilisers
fertilizes=fertilises
fertilizing=fertilising
fervor=fervour
fervor's=fervour's
fetal=foetal
fetid=foetid
fiberboard=fibreboard
fiberboard's=fibreboard's
fiber=fibre
fiberfill=fibrefill
fiberfill's=fibrefill's
fiberglass=fibreglass
fiberglass's=fibreglass's
fiber's=fibre's
fibers=fibres
fictionalization=fictionalisation
fictionalization's=fictionalisation's
fictionalizations=fictionalisations
fictionalized=fictionalised
fictionalize=fictionalise
fictionalizes=fictionalises
fictionalizing=fictionalising
finalization=finalisation
finalization's=finalisation's
finalized=finalised
finalize=finalise
finalizes=finalises
finalizing=finalising
flanneled=flannelled
flannelet=flannelette
flannelet's=flannelette's
flanneling=flannelling
flavored=flavoured
flavor=flavour
flavorful=flavourful
flavoring=flavouring
flavoring's=flavouring's
flavorings=flavourings
flavorless=flavourless
flavor's=flavour's
flavors=flavours
flavorsome=flavoursome
flutist=flautist
flutist's=flautist's
flutists=flautists
formalization=formalisation
formalization's=formalisation's
formalized=formalised
formalize=formalise
formalizes=formalises
formalizing=formalising
fossilization=fossilisation
fossilization's=fossilisation's
fossilized=fossilised
fossilize=fossilise
fossilizes=fossilises
fossilizing=fossilising
fraternization=fraternisation
fraternization's=fraternisation's
fraternized=fraternised
fraternize=fraternise
fraternizer=fraterniser
fraternizer's=fraterniser's
fraternizers=fraternisers
fraternizes=fraternises
fraternizing=fraternising
fueled=fuelled
fueling=fuelling
fulfill=fulfil
fulfillment=fulfillment
fulfillment's=fulfillment's
fulfills=fulfils
funneled=funnelled
funneling=funnelling
furor=furore
furor's=furore's
fuzed=fused
fuze=fuse
fuze's=fuse's
fuzes=fuses
fuzing=fusing
gaged=gauged
gage=gauge
gage's=gauge's
gages=gauges
gaging=gauging
galvanization=galvanisation
galvanization's=galvanisation's
galvanized=galvanised
galvanize=galvanise
galvanizes=galvanises
galvanizing=galvanising
gamboled=gambolled
gamboling=gambolling
gemology=gemmology
gemology's=gemmology's
generalization=generalisation
generalization's=generalisation's
generalizations=generalisations
generalized=generalised
generalize=generalise
generalizes=generalises
generalizing=generalising
ghettoized=ghettoised
ghettoize=ghettoise
ghettoizes=ghettoises
ghettoizing=ghettoising
glamored=glamoured
glamor=glamour
glamoring=glamouring
glamorization=glamorisation
glamorization's=glamorisation's
glamorized=glamorised
glamorize=glamorise
glamorizes=glamorises
glamorizing=glamorising
glamor's=glamour's
glamors=glamours
glamourization=glamourisation
globalization=globalisation
globalization's=globalisation's
globalized=globalised
globalize=globalise
globalizes=globalises
globalizing=globalising
glycerin=glycerine
glycerin's=glycerine's
goiter=goitre
goiter's=goitre's
goiters=goitres
gonorrhea=gonorrhoea
gonorrheal=gonorrhoeal
gonorrhea's=gonorrhoea's
goodby=goodbye
goodby's=goodbye's
goodbys=goodbyes
gormandized=gormandised
gormandize=gormandise
gormandizer=gormandiser
gormandizer's=gormandiser's
gormandizers=gormandisers
gormandizes=gormandises
gormandizing=gormandising
gram=grammme
gram's=gramme's
graveled=gravelled
graveling=gravelling
grayed=greyed
grayer=greyer
grayest=greyest
gray=grey
graying=greying
grayish=greyish
grayness=greyness
grayness's=greyness's
gray's=grey's
grays=greys
groin=groyne
groin's=groyne's
groins=groynes
groveled=grovelled
groveler=groveller
groveler's=groveller's
grovelers=grovellers
groveling=grovelling
grueling=gruelling
gruelingly=gruellingly
gruelings=gruellings
gynecological=gynaecological
gynecologic=gynaecologic
gynecologist=gynaecologist
gynecologist's=gynaecologist's
gynecologists=gynaecologists
gynecology=gynaecology
gynecology's=gynaecology's
harbored=harboured
harbor=harbour
harboring=harbouring
harbor's=harbour's
harbors=harbours
harmonization=harmonisation
harmonization's=harmonisation's
harmonized=harmonised
harmonize=harmonise
harmonizer=harmoniser
harmonizer's=harmoniser's
harmonizers=harmonisers
harmonizes=harmonises
harmonizing=harmonising
hectogram=hectogramme
hectogram's=hectogramme's
hectograms=hectogrammes
hectometer=hectometre
hectometer's=hectometre's
hectometers=hectometres
Hellenization=Hellenisation
Hellenization's=Hellenisation's
Hellenize=Hellenise
hematite=haematite
hematite's=haematite's
hematological=haematological
hematologic=haematologic
hematologist=haematologist
hematologist's=haematologist's
hematologists=haematologists
hematology=haematology
hematology's=haematology's
hemoglobin=haemoglobin
hemoglobin's=haemoglobin's
hemophiliac=haemophiliac
hemophiliac's=haemophiliac's
hemophiliacs=haemophiliacs
hemophilia=haemophilia
hemophilia's=haemophilia's
hemorrhaged=haemorrhaged
hemorrhage=haemorrhage
hemorrhage's=haemorrhage's
hemorrhages=haemorrhages
hemorrhaging=haemorrhaging
hemorrhoid=haemorrhoid
hemorrhoids=haemorrhoids
homeopath=homoeopath
homeopathic=homoeopathic
homeopath's=homoeopath's
homeopaths=homoeopaths
homeopathy=homoeopathy
homeopathy's=homoeopathy's
homeostasis=homoeostasis
homeostasis's=homoeostasis's
homeostatic=homoeostatic
homogenization=homogenisation
homogenization's=homogenisation's
homogenized=homogenised
homogenize=homogenise
homogenizes=homogenises
homogenizing=homogenising
honorable=honourable
Honorable=Honourable
honorableness=honourableness
honorableness's=honourableness's
honorably=honourably
honored=honoured
honoree=honouree
honoree's=honouree's
honorees=honourees
honorer=honourer
honorer's=honourer's
honorers=honourers
honor=honour
honoring=honouring
honor's=honour's
honors=honours
hospitalization=hospitalisation
hospitalization's=hospitalisation's
hospitalizations=hospitalisations
hospitalized=hospitalised
hospitalize=hospitalise
hospitalizes=hospitalises
hospitalizing=hospitalising
humanization=humanisation
humanization's=humanisation's
humanized=humanised
humanize=humanise
humanizer=humaniser
humanizer's=humaniser's
humanizers=humanisers
humanizes=humanises
humanizing=humanising
humored=humoured
humor=humour
humoring=humouring
humorless=humourless
humorlessness=humourlessness
humorlessness's=humourlessness's
humor's=humour's
humors=humours
hybridization=hybridisation
hybridization's=hybridisation's
hybridized=hybridised
hybridize=hybridise
hybridizes=hybridises
hybridizing=hybridising
hydrolyzed=hydrolysed
hydrolyze=hydrolyse
hydrolyzes=hydrolyses
hydrolyzing=hydrolysing
hypnotized=hypnotised
hypnotize=hypnotise
hypnotizes=hypnotises
hypnotizing=hypnotising
hypothesized=hypothesised
hypothesize=hypothesise
hypothesizes=hypothesises
hypothesizing=hypothesising
idealization=idealisation
idealization's=idealisation's
idealizations=idealisations
idealized=idealised
idealize=idealise
idealizes=idealises
idealizing=idealising
idolization=idolisation
idolization's=idolisation's
idolized=idolised
idolize=idolise
idolizes=idolises
idolizing=idolising
immobilization=immobilisation
immobilization's=immobilisation's
immobilized=immobilised
immobilize=immobilise
immobilizer=immobiliser
immobilizers=immobilisers
immobilizes=immobilises
immobilizing=immobilising
immortalized=immortalised
immortalize=immortalise
immortalizes=immortalises
immortalizing=immortalising
immunization=immunisation
immunization's=immunisation's
immunizations=immunisations
immunized=immunised
immunize=immunise
immunizes=immunises
immunizing=immunising
impaneled=impanelled
impaneling=impanelling
impeled=impelled
impeler=impeller
impeling=impelling
imperiled=imperilled
imperiling=imperilling
inclosed=enclosed
inclose=enclose
incloses=encloses
inclosing=enclosing
individualization=individualisation
individualization's=individualisation's
individualized=individualised
individualize=individualise
individualizes=individualises
individualizing=individualising
industrialization=industrialisation
industrialization's=industrialisation's
industrialized=industrialised
industrialize=industrialise
industrializes=industrialises
industrializing=industrialising
inflection=inflexion
inflection's=inflexion's
inflections=inflexions
initialed=initialled
initialing=initialling
initialization=initialisation
initialized=initialised
initialize=initialise
initializes=initialises
initializing=initialising
installment=instalment
installment's=instalment's
installments=instalments
institutionalization=institutionalisation
institutionalization's=institutionalisation's
institutionalized=institutionalised
institutionalize=institutionalise
institutionalizes=institutionalises
institutionalizing=institutionalising
intellectualized=intellectualised
intellectualize=intellectualise
intellectualizes=intellectualises
intellectualizing=intellectualising
internalization=internalisation
internalization's=internalisation's
internalized=internalised
internalize=internalise
internalizes=internalises
internalizing=internalising
internationalization=internationalisation
internationalized=internationalised
internationalize=internationalise
internationalizes=internationalises
internationalizing=internationalising
iodized=iodised
iodize=iodise
iodizes=iodises
iodizing=iodising
ionization=ionisation
ionization's=ionisation's
ionized=ionised
ionize=ionise
ionizes=ionises
ionizing=ionising
ischemia=ischaemia
ischemic=ischaemic
italicization=italicisation
italicization's=italicisation's
italicized=italicised
italicize=italicise
italicizes=italicises
italicizing=italicising
itemization=itemisation
itemization's=itemisation's
itemized=itemised
itemize=itemise
itemizes=itemises
itemizing=itemising
jailor=gaolor
jailor's=gaolor's
jailors=gaolors
jeopardized=jeopardised
jeopardize=jeopardise
jeopardizes=jeopardises
jeopardizing=jeopardising
jeweled=jewelled
jeweler=jeweller
jeweler's=jeweller's
jewelers=jewellers
jeweling=jewelling
jewelry=jewellery
jewelry's=jewellery's
kenneled=kennelled
kenneling=kennelling
kidnaped=kidnapped
kidnaper=kidnapper
kidnaper's=kidnapper's
kidnapers=kidnappers
kidnaping=kidnapping
kilogram=kilogramme
kilogram's=kilogramme's
kiloliter=kilolitre
kiloliter's=kilolitre's
kiloliters=kilolitres
kilometer=kilometre
kilometer's=kilometre's
kilometers=kilometres
kindergartner=kindergartener
kindergartner's=kindergartener's
kindergartners=kindergarteners
kneled=knelled
labeled=labelled
labeling=labelling
labored=laboured
laborer=labourer
laborer's=labourer's
laborers=labourers
laboring=labouring
labor=labour
laborsaving=laboursaving
labor's=labour's
labors=labours
lackluster=lacklustre
legalization=legalisation
legalization's=legalisation's
legalized=legalised
legalize=legalise
legalizes=legalises
legalizing=legalising
leggin=legging
leggin's=legging's
leggins=leggings
legitimatized=legitimatised
legitimatize=legitimatise
legitimatizes=legitimatises
legitimatizing=legitimatising
legitimization=legitimisation
legitimization's=legitimisation's
legitimized=legitimised
legitimize=legitimise
legitimizes=legitimises
legitimizing=legitimising
leukemia=leukaemia
leukemia's=leukaemia's
leveled=levelled
leveler=leveller
leveler's=leveller's
levelers=levellers
leveling=levelling
libeled=libelled
libeler=libeller
libeler's=libeller's
libelers=libellers
libeling=libelling
libelous=libellous
liberalization=liberalisation
liberalization's=liberalisation's
liberalizations=liberalisations
liberalized=liberalised
liberalize=liberalise
liberalizes=liberalises
liberalizing=liberalising
license's=licence's
likability=likeability
likability's=likeability's
likableness=likeableness
likableness's=likeableness's
lionization=lionisation
lionization's=lionisation's
lionized=lionised
lionize=lionise
lionizes=lionises
lionizing=lionising
liquidized=liquidised
liquidize=liquidise
liquidizer=liquidiser
liquidizer's=liquidiser's
liquidizers=liquidisers
liquidizes=liquidises
liquidizing=liquidising
liter=litre
liter's=litre's
liters=litres
livable=liveable
lobotomized=lobotomised
lobotomize=lobotomise
lobotomizes=lobotomises
lobotomizing=lobotomising
localization=localisation
localization's=localisation's
localized=localised
localize=localise
localizes=localises
localizing=localising
louvered=louvre
louver=louvre
louver's=louvres
louvers=louvre's
lovableness=loveableness
lovably=loveably
loyaly=loyally
lusterless=lustreless
luster=lustre
luster's=lustre's
macadamized=macadamised
macadamize=macadamise
macadamizes=macadamises
macadamizing=macadamising
magnetizable=magnetisable
magnetization=magnetisation
magnetization's=magnetisation's
magnetized=magnetised
magnetize=magnetise
magnetizes=magnetises
magnetizing=magnetising
maneuverability=manoeuverability
maneuverability's=manoeuverability's
maneuverable=manoeuverable
maneuvered=manoeuvered
maneuvering=manoeuvering
maneuverings=manoeuverings
maneuver=manoeuver
maneuver's=manoeuver's
maneuvers=manoeuvers
manila=manilla
manila's=manilla's
mantes=mantoes
marbleized=marbleised
marbleize=marbleise
marbleizes=marbleises
marbleizing=marbleising
marginalization=marginalisation
marginalized=marginalised
marginalize=marginalise
marginalizes=marginalises
marginalizing=marginalising
marshaled=marshalled
marshaling=marshalling
marveled=marvelled
marveling=marvelling
marvelously=marvellously
marvelous=marvellous
materialization=materialisation
materialization's=materialisation's
materialized=materialised
materialize=materialise
materializes=materialises
materializing=materialising
maters=matres
maximization=maximisation
maximization's=maximisation's
maximized=maximised
maximize=maximise
maximizes=maximises
maximizing=maximising
meager=meagre
mechanization=mechanisation
mechanization's=mechanisation's
mechanized=mechanised
mechanize=mechanise
mechanizes=mechanises
mechanizing=mechanising
medalist=medallist
medalist's=medallist's
medalists=medallists
memorialized=memorialised
memorialize=memorialise
memorializes=memorialises
memorializing=memorialising
memorization=memorisation
memorization's=memorisation's
memorized=memorised
memorize=memorise
memorizes=memorises
memorizing=memorising
mercerized=mercerised
mercerize=mercerise
mercerizes=mercerises
mercerizing=mercerising
mesmerized=mesmerised
mesmerize=mesmerise
mesmerizer=mesmeriser
mesmerizer's=mesmeriser's
mesmerizers=mesmerisers
mesmerizes=mesmerises
mesmerizing=mesmerising
metabolized=metabolised
metabolize=metabolise
metabolizes=metabolises
metabolizing=metabolising
metaled=metalled
metastasized=metastasised
metastasize=metastasise
metastasizes=metastasises
metastasizing=metastasising
meter=metre
meter's=metre's
meters=metres
metricized=metricised
metricize=metricise
metricizes=metricises
metricizing=metricising
micrometer=micrometre
micrometer's=micrometre's
micrometers=micrometres
militarization=militarisation
militarization's=militarisation's
militarized=militarised
militarize=militarise
militarizes=militarises
militarizing=militarising
milligram=milligramme
milligram's=milligramme's
milligrams=milligrammes
milliliter=millilitre
milliliter's=millilitre's
milliliters=millilitres
millimeter=millimetre
millimeter's=millimetre's
millimeters=millimetres
miniaturization=miniaturisation
miniaturization's=miniaturisation's
miniaturized=miniaturised
miniaturize=miniaturise
miniaturizes=miniaturises
miniaturizing=miniaturising
minibusses=minibuses
minimization=minimisation
minimization's=minimisation's
minimized=minimised
minimize=minimise
minimizes=minimises
minimizing=minimising
misbehavior=misbehaviour
misbehavior's=misbehaviour's
misdemeanor=misdemeanour
misdemeanor's=misdemeanour's
misdemeanors=misdemeanours
mislabeled=mislabelled
mislabeling=mislabelling
mitered=mitred
miteres=mitres
mitering=mitring
miter=mitre
miter's=mitre's
miters=mitres
mobilization=mobilisation
mobilization's=mobilisation's
mobilizations=mobilisations
mobilized=mobilised
mobilize=mobilise
mobilizer=mobiliser
mobilizer's=mobiliser's
mobilizers=mobilisers
mobilizes=mobilises
mobilizing=mobilising
modeled=modelled
modeler=modeller
modeler's=modeller's
modelers=modellers
modeling=modelling
modeling's=modelling's
modelings=modellings
modernization=modernisation
modernization's=modernisation's
modernized=modernised
modernize=modernise
modernizer=moderniser
modernizer's=moderniser's
modernizers=modernisers
modernizes=modernises
modernizing=modernising
moisturized=moisturised
moisturize=moisturise
moisturizer=moisturiser
moisturizer's=moisturiser's
moisturizers=moisturisers
moisturizes=moisturises
moisturizing=moisturising
molded=moulded
moldered=mouldered
moldering=mouldering
molder=moulder
molder's=moulder's
molders=moulders
moldier=mouldier
moldiest=mouldiest
molding=moulding
molding's=moulding's
moldings=mouldings
mold=mould
mold's=mould's
molds=moulds
moldy=mouldy
molluskan=molluscan
mollusk=mollusc
mollusk's=mollusc's
mollusks=molluscs
molted=moulted
molting=moulting
molt=moult
molt=moults
molt's=moult's
molts=moults
monetized=monetised
monetize=monetise
monetizes=monetises
monetizing=monetising
monolog=monologue
monolog's=monologue's
monologs=monologues
monopolization=monopolisation
monopolization's=monopolisation's
monopolized=monopolised
monopolize=monopolise
monopolizer=monopoliser
monopolizer's=monopoliser's
monopolizers=monopolisers
monopolizes=monopolises
monopolizing=monopolising
moralization=moralisation
moralization's=moralisation's
moralized=moralised
moralize=moralise
moralizer=moraliser
moralizer's=moraliser's
moralizers=moralisers
moralizes=moralises
moralizing=moralising
motorization=motorisation
motorization's=motorisation's
motorized=motorised
motorize=motorise
motorizes=motorises
motorizing=motorising
multicolored=multicoloured
mustached=moustached
mustache=moustache
mustache's=moustache's
mustaches=moustaches
mythologized=mythologised
mythologize=mythologise
mythologizes=mythologises
mythologizing=mythologising
narcotization=narcotisation
narcotization's=narcotisation's
narcotized=narcotised
narcotize=narcotise
narcotizes=narcotises
narcotizing=narcotising
nasalization=nasalisation
nasalization's=nasalisation's
nasalized=nasalised
nasalize=nasalise
nasalizes=nasalises
nasalizing=nasalising
nationalization=nationalisation
nationalization's=nationalisation's
nationalizations=nationalisations
nationalized=nationalised
nationalize=nationalise
nationalizes=nationalises
nationalizing=nationalising
naturalization=naturalisation
naturalization's=naturalisation's
naturalized=naturalised
naturalize=naturalise
naturalizes=naturalises
naturalizing=naturalising
neighbored=neighboured
neighborhood=neighbourhood
neighborhood's=neighbourhood's
neighborhoods=neighbourhoods
neighboring=neighbouring
neighborliness=neighbourliness
neighborliness's=neighbourliness's
neighborly=neighbourly
neighbor=neighbour
neighbor's=neighbour's
neighbors=neighbours
neutralization=neutralisation
neutralization's=neutralisation's
neutralized=neutralised
neutralize=neutralise
neutralizer=neutraliser
neutralizer's=neutraliser's
neutralizers=neutralisers
neutralizes=neutralises
neutralizing=neutralising
nite=nitre
niter=nitre
niter's=nitre's
nites=nights
nite's=nitre's
nitroglycerin=nitroglycerine
nitroglycerin's=nitroglycerine's
nonsympathizer=nonsympathiser
nonsympathizer's=nonsympathiser's
normalization=normalisation
normalization's=normalisation's
normalized=normalised
normalize=normalise
normalizes=normalises
normalizing=normalising
notarization=notarisation
notarized=notarised
notarize=notarise
notarizes=notarises
notarizing=notarising
novelization=novelisation
novelization's=novelisation's
novelizations=novelisations
novelized=novelised
novelize=novelise
novelizes=novelises
novelizing=novelising
ocher=ochre
ocher's=ochre's
odored=odoured
odorless=odourless
odor=odour
odor's=odour's
odors=odours
offense=offence
offense's=offence's
offenses=offences
omelet=omelette
omelet's=omelette's
omelets=omelettes
optimization=optimisation
optimization's=optimisation's
optimizations=optimisations
optimized=optimised
optimize=optimise
optimizer=optimiser
optimizes=optimises
optimizing=optimising
organdy=organdie
organdy's=organdie's
organizationally=organisationally
organizational=organisational
organization=organisation
organization's=organisation's
organizations=organisations
organized=organised
organize=organise
organizer=organiser
organizer's=organiser's
organizers=organisers
organizes=organises
organizing=organising
orthopedic=orthopaedic
orthopedics=orthopaedics
orthopedics's=orthopaedics's
orthopedist=orthopaedist
orthopedist's=orthopaedist's
orthopedists=orthopaedists
ostracized=ostracised
ostracize=ostracise
ostracizes=ostracises
ostracizing=ostracising
outmaneuvered=outmanoeuvered
outmaneuvering=outmanoeuvering
outmaneuver=outmanoeuver
outmaneuvers=outmanoeuvers
overcapitalized=overcapitalised
overcapitalize=overcapitalise
overcapitalizes=overcapitalises
overcapitalizing=overcapitalising
overemphasized=overemphasised
overemphasize=overemphasise
overemphasizes=overemphasises
overemphasizing=overemphasising
overgeneralized=overgeneralised
overgeneralize=overgeneralise
overgeneralizes=overgeneralises
overgeneralizing=overgeneralising
overspecialization=overspecialisation
overspecialization's=overspecialisation's
overspecialized=overspecialised
overspecialize=overspecialise
overspecializes=overspecialises
overspecializing=overspecialising
oxidization=oxidisation
oxidization's=oxidisation's
oxidized=oxidised
oxidize=oxidise
oxidizer=oxidiser
oxidizer's=oxidiser's
oxidizers=oxidisers
oxidizes=oxidises
oxidizing=oxidising
pajama=pyjama
pajamas=pyjamas
pajamas's=pyjamas's
palatalization=palatalisation
palatalization's=palatalisation's
palatalized=palatalised
palatalize=palatalise
palatalizes=palatalises
palatalizing=palatalising
paleolithic=palaeolithic
Paleolithic=Palaeolithic
paleontologist=palaeontologist
paleontologist's=palaeontologist's
paleontologists=palaeontologists
paleontology=palaeontology
paleontology's=palaeontology's
paneled=panelled
paneling=panelling
paneling's=panelling's
panelings=panellings
panelist=panellist
panelist's=panellist's
panelists=panellists
paralyzed=paralysed
paralyze=paralyse
paralyzes=paralyses
paralyzingly=paralysingly
paralyzing=paralysing
parceled=parcelled
parceling=parcelling
parenthesized=parenthesised
parenthesize=parenthesise
parenthesizes=parenthesises
parenthesizing=parenthesising
parlor=parlour
parlor's=parlour's
parlors=parlours
particularization=particularisation
particularization's=particularisation's
particularized=particularised
particularize=particularise
particularizes=particularises
particularizing=particularising
passivization=passivisation
pasteurization=pasteurisation
pasteurization's=pasteurisation's
pasteurized=pasteurised
pasteurize=pasteurise
pasteurizer=pasteuriser
pasteurizer's=pasteuriser's
pasteurizers=pasteurisers
pasteurizes=pasteurises
pasteurizing=pasteurising
patroled=patrolled
patroling=patrolling
patronized=patronised
patronize=patronise
patronizer=patroniser
patronizer's=patroniser's
patronizers=patronisers
patronizes=patronises
patronizingly=patronisingly
patronizing=patronising
pauperized=pauperised
pauperize=pauperise
pauperizes=pauperises
pauperizing=pauperising
pedagog=pedagogue
pedagog's=pedagogue's
pedagogs=pedagogues
pedaled=pedalled
pedaling=pedalling
peddler=pedlar
peddler's=pedlar's
peddlers=pedlars
pedestrianization=pedestrianisation
pedestrianized=pedestrianised
pedestrianize=pedestrianise
pedestrianizes=pedestrianises
pedestrianizing=pedestrianising
pediatrician=paediatrician
pediatrician's=paediatrician's
pediatricians=paediatricians
pediatric=paediatric
pediatrics=paediatrics
pediatrist=paediatrist
pediatrist's=paediatrist's
pediatrists=paediatrists
pedophile=paedophile
pedophiles=paedophiles
pedophilia=paedophilia
penalization=penalisation
penalization's=penalisation's
penalized=penalised
penalize=penalise
penalizes=penalises
penalizing=penalising
penciled=pencilled
penciling=pencilling
pencilings=pencillings
performative=preformative
periled=perilled
periling=perilling
personalized=personalised
personalize=personalise
personalizes=personalises
personalizing=personalising
petaled=petalled
philosophized=philosophised
philosophize=philosophise
philosophizer=philosophiser
philosophizer's=philosophiser's
philosophizers=philosophisers
philosophizes=philosophises
philosophizing=philosophising
philter=philtre
philter's=philtre's
philters=philtres
photosynthesized=photosynthesised
photosynthesize=photosynthesise
photosynthesizes=photosynthesises
photosynthesizing=photosynthesising
piaster=piastre
piaster's=piastre's
piasters=piastres
plagiarized=plagiarised
plagiarize=plagiarise
plagiarizer=plagiariser
plagiarizer's=plagiariser's
plagiarizers=plagiarisers
plagiarizes=plagiarises
plagiarizing=plagiarising
plasticized=plasticised
plasticize=plasticise
plasticizes=plasticises
plasticizing=plasticising
plowed=ploughed
plowing=ploughing
plowman=ploughman
plowman's=ploughman's
plowmen=ploughmen
plow=plough
plowshare=ploughshare
plowshare's=ploughshare's
plowshares=ploughshares
plow's=plough's
plows=ploughs
pluralization=pluralisation
pluralization's=pluralisation's
pluralized=pluralised
pluralize=pluralise
pluralizes=pluralises
pluralizing=pluralising
polarization=polarisation
polarization's=polarisation's
polarized=polarised
polarize=polarise
polarizes=polarises
polarizing=polarising
politicization=politicisation
politicization's=politicisation's
politicized=politicised
politicize=politicise
politicizes=politicises
politicizing=politicising
polymerization=polymerisation
polymerization's=polymerisation's
polymerized=polymerised
polymerize=polymerise
polymerizes=polymerises
polymerizing=polymerising
pommeled=pommelled
pommeling=pommelling
popularization=popularisation
popularization's=popularisation's
popularized=popularised
popularize=popularise
popularizes=popularises
popularizing=popularising
practiced=practised
practicing=practising
presidia=praesidia
pressurization=pressurisation
pressurization's=pressurisation's
pressurized=pressurised
pressurize=pressurise
pressurizer=pressuriser
pressurizers=pressurisers
pressurizes=pressurises
pressurizing=pressurising
pretense=pretence
pretense's=pretence's
pretenses=pretences
preterit=preterite
preterit's=preterite's
preterits=preterites
prevue=preview
prevue's=preview's
prevues=previews
prioritization=prioritisation
prioritized=prioritised
prioritize=prioritise
prioritizes=prioritises
prioritizing=prioritising
privatization=privatisation
privatization's=privatisation's
privatizations=privatisations
privatized=privatised
privatize=privatise
privatizes=privatises
privatizing=privatising
prized=prised
prize=prise
prizes=prises
prizing=prising
professionalization=professionalisation
professionalized=professionalised
professionalize=professionalise
professionalizes=professionalises
professionalizing=professionalising
programed=programmed
programer=programmer
programer's=programmer's
programers=programmers
programing=programming
program=programme
program's=programme's
programs=programms
prolog=prologue
prolog's=prologue's
prologs=prologues
propagandized=propagandised
propagandize=propagandise
propagandizes=propagandises
propagandizing=propagandising
propeled=propelled
propeler=propeller
propeling=propelling
proselytized=proselytised
proselytize=proselytise
proselytizer=proselytiser
proselytizer's=proselytiser's
proselytizers=proselytisers
proselytizes=proselytises
proselytizing=proselytising
psychoanalyzed=psychoanalysed
psychoanalyze=psychoanalyse
psychoanalyzes=psychoanalyses
psychoanalyzing=psychoanalysing
publicized=publicised
publicize=publicise
publicizes=publicises
publicizing=publicising
pulverization=pulverisation
pulverization's=pulverisation's
pulverized=pulverised
pulverize=pulverise
pulverizes=pulverises
pulverizing=pulverising
pummeled=pummelled
pummeling=pummelling
pyorrhea=pyorrhoea
pyorrhea's=pyorrhoea's
quarreled=quarrelled
quarreler=quarreller
quarreler's=quarreller's
quarrelers=quarrellers
quarreling=quarrelling
queuing=queueing
radicalization=radicalisation
radicalization's=radicalisation's
radicalized=radicalised
radicalize=radicalise
radicalizes=radicalises
radicalizing=radicalising
rancor=rancour
rancor's=rancour's
randomization=randomisation
randomization's=randomisation's
randomized=randomised
randomize=randomise
randomizes=randomises
randomizing=randomising
rappeled=rappelled
rappeling=rappelling
rationalization=rationalisation
rationalization's=rationalisation's
rationalizations=rationalisations
rationalized=rationalised
rationalize=rationalise
rationalizes=rationalises
rationalizing=rationalising
raveled=ravelled
raveling=ravelling
ravelings=ravellings
realizable=realisable
realization=realisation
realization's=realisation's
realizations=realisations
realized=realised
realize=realise
realizes=realises
realizing=realising
reanalyzed=reanalysed
reanalyze=reanalyse
reanalyzes=reanalyses
reanalyzing=reanalysing
reauthorize=reauthorise
reauthorizes=reauthorises
rebeled=rebelled
recapitalization=recapitalisation
recapitalized=recapitalised
recapitalize=recapitalise
recapitalizes=recapitalises
recapitalizing=recapitalising
recognizable=recognisable
recognizably=recognisably
recognizance=recognisance
recognizance's=recognisance's
recognized=recognised
recognize=recognise
recognizer=recogniser
recognizes=recognises
recognizing=recognising
recolonization=recolonisation
recolonization's=recolonisation's
recolonized=recolonised
recolonize=recolonise
recolonizes=recolonises
recolonizing=recolonising
recolored=recoloured
recoloring=recolouring
recolor=recolour
recolors=recolours
reconnoitered=reconnoitred
reconnoiteres=reconnoitres
reconnoitering=reconnoitring
reconnoiter=reconnoitre
reconnoiters=reconnoitres
recrystallized=recrystallised
recrystallize=recrystallise
recrystallizes=recrystallises
recrystallizing=recrystallising
redialed=redialled
redialing=redialling
reemphasized=reemphasised
reemphasize=reemphasise
reemphasizes=reemphasises
reemphasizing=reemphasising
reenforced=re-enforced
reenforce=re-enforce
reenforces=re-enforces
reenforcing=re-enforcing
refueled=refuelled
refueling=refuelling
regularization=regularisation
regularization's=regularisation's
regularized=regularised
regularize=regularise
regularizes=regularises
regularizing=regularising
reinitialized=reinitialised
reinitialize=reinitialise
relabeled=relabelled
relabeling=relabelling
remodeled=remodelled
remodeling=remodelling
remolded=remoulded
remolding=remoulding
remold=remould
remolds=remoulds
reorganization=reorganisation
reorganization's=reorganisation's
reorganizations=reorganisations
reorganized=reorganised
reorganize=reorganise
reorganizes=reorganises
reorganizing=reorganising
repeled=repelled
repeling=repelling
reprized=reprised
reprogramed=reprogrammed
reprograming=reprogramming
reprogram=reprogramme
reprograms=reprogrammes
reveled=revelled
reveler=reveller
reveler's=reveller's
revelers=revellers
reveling=revelling
revelings=revellings
revitalization=revitalisation
revitalization's=revitalisation's
revitalized=revitalised
revitalize=revitalise
revitalizes=revitalises
revitalizing=revitalising
revolutionized=revolutionised
revolutionize=revolutionise
revolutionizes=revolutionises
revolutionizing=revolutionising
rhapsodized=rhapsodised
rhapsodize=rhapsodise
rhapsodizes=rhapsodises
rhapsodizing=rhapsodising
rigor=rigour
rigor's=rigour's
rigors=rigours
ritualized=ritualised
rivaled=rivalled
rivaling=rivalling
robotized=robotised
robotize=robotise
robotizes=robotises
robotizing=robotising
romanticized=romanticised
romanticize=romanticise
romanticizes=romanticises
romanticizing=romanticising
routinized=routinised
routinize=routinise
routinizes=routinises
routinizing=routinising
roweled=rowelled
roweling=rowelling
rubberized=rubberised
rubberize=rubberise
rubberizes=rubberises
rubberizing=rubberising
ruble=rouble
ruble's=rouble's
rubles=roubles
rumored=rumoured
rumoring=rumouring
rumormonger=rumourmonger
rumormonger's=rumourmonger's
rumormongers=rumourmongers
rumor=rumour
rumor's=rumour's
rumors=rumours
saber=sabre
saber's=sabre's
sabers=sabres
salable=saleable
saltpeter=saltpetre
saltpeter's=saltpetre's
sanitized=sanitised
sanitize=sanitise
sanitizes=sanitises
sanitizing=sanitising
satirized=satirised
satirize=satirise
satirizes=satirises
satirizing=satirising
savior=saviour
savior's=saviour's
saviors=saviours
savored=savoured
savorier=savourier
savories=savouries
savoriest=savouriest
savoriness=savouriness
savoriness's=savouriness's
savoring=savouring
savor=savour
savor's=savour's
savors=savours
savory=savoury
savory's=savoury's
scandalized=scandalised
scandalize=scandalise
scandalizes=scandalises
scandalizing=scandalising
scepter=sceptre
scepter's=sceptre's
scepters=sceptres
schematized=schematised
schematize=schematise
schematizes=schematises
schematizing=schematising
scrutinized=scrutinised
scrutinize=scrutinise
scrutinizes=scrutinises
scrutinizing=scrutinising
seborrhea=seborrhoea
seborrhea's=seborrhoea's
secularization=secularisation
secularization's=secularisation's
secularized=secularised
secularize=secularise
secularizes=secularises
secularizing=secularising
sensationalized=sensationalised
sensationalize=sensationalise
sensationalizes=sensationalises
sensationalizing=sensationalising
sensitization=sensitisation
sensitization's=sensitisation's
sensitized=sensitised
sensitize=sensitise
sensitizes=sensitises
sensitizing=sensitising
sentimentalization=sentimentalisation
sentimentalization's=sentimentalisation's
sentimentalized=sentimentalised
sentimentalize=sentimentalise
sentimentalizes=sentimentalises
sentimentalizing=sentimentalising
septicemia=septicaemia
septicemia's=septicaemia's
septicemic=septicaemic
sepulchered=sepulchred
sepulcheres=sepulchres
sepulchering=sepulchring
sepulcher=sepulchre
sepulcher's=sepulchre's
sepulchers=sepulchres
serialization=serialisation
serialization's=serialisation's
serializations=serialisations
serialized=serialised
serialize=serialise
serializes=serialises
serializing=serialising
sermonized=sermonised
sermonize=sermonise
sermonizes=sermonises
sermonizing=sermonising
shaikh=sheik
shaikh's=sheik's
shaikhs=sheiks
shoveled=shovelled
shoveling=shovelling
shriveled=shrivelled
shriveling=shrivelling
signaled=signalled
signaler=signaller
signaler's=signaller's
signalers=signallers
signaling=signalling
signalization=signalisation
signalized=signalised
signalize=signalise
signalizes=signalises
signalizing=signalising
simonize=simonise
sirup's=syrup's
sirups=syrups
sirup=syrup
skeptically=sceptically
skeptical=sceptical
skepticism=scepticism
skepticism's=scepticism's
skeptic=sceptic
skeptic's=sceptic's
skeptics=sceptics
slenderized=slenderised
slenderize=slenderise
slenderizes=slenderises
slenderizing=slenderising
smoldered=smouldered
smoldering=smouldering
smolder=smoulder
smolder's=smoulder's
smolders=smoulders
sniveled=snivelled
sniveler=sniveller
sniveler's=sniveller's
snivelers=snivellers
sniveling=snivelling
snorkeled=snorkelled
snorkeling=snorkelling
snowplow=snowplough
snowplow's=snowplough's
snowplows=snowploughs
socialization=socialisation
socialization's=socialisation's
socialized=socialised
socialize=socialise
socializes=socialises
socializing=socialising
sodomized=sodomised
sodomize=sodomise
sodomizes=sodomises
sodomizing=sodomising
solemnization=solemnisation
solemnization's=solemnisation's
solemnized=solemnised
solemnize=solemnise
solemnizes=solemnises
solemnizing=solemnising
soliloquized=soliloquised
soliloquize=soliloquise
soliloquizes=soliloquises
soliloquizing=soliloquising
somberly=sombrely
somberness=sombreness
somberness's=sombreness's
somber=sombre
specialization=specialisation
specialization's=specialisation's
specializations=specialisations
specialized=specialised
specialize=specialise
specializes=specialises
specializing=specialising
specialties=specialities
specialty=speciality
specialty's=speciality's
specter=spectre
specter's=spectre's
specters=spectres
spiraled=spiralled
spiraling=spiralling
spirochete=spirochaete
spirochete's=spirochaete's
spirochetes=spirochaetes
splendor=splendour
splendor's=splendour's
splendors=splendours
squirreled=squirrelled
squirreling=squirrelling
stabilization's=stabilisation's
stabilization=stabilisation
stabilized=stabilised
stabilizer's=stabiliser's
stabilizers=stabilisers
stabilizer=stabiliser
stabilizes=stabilises
stabilize=stabilise
stabilizing=stabilising
standardization's=standardisation's
standardization=standardisation
standardized=standardised
standardizes=standardises
standardize=standardise
standardizing=standardising
stenciled=stencilled
stenciling=stencilling
sterilization's=sterilisation's
sterilizations=sterilisations
sterilization=sterilisation
sterilized=sterilised
sterilizer's=steriliser's
sterilizers=sterilisers
sterilizer=steriliser
sterilizes=sterilises
sterilize=sterilise
sterilizing=sterilising
stigmatization's=stigmatisation's
stigmatization=stigmatisation
stigmatized=stigmatised
stigmatizes=stigmatises
stigmatize=stigmatise
stigmatizing=stigmatising
stylized=stylised
stylizes=stylises
stylize=stylise
stylizing=stylising
subprograms=subprogrammes
subprogram=subprogramme
subsidization's=subsidisation's
subsidization=subsidisation
subsidized=subsidised
subsidizer's=subsidiser's
subsidizers=subsidisers
subsidizer=subsidiser
subsidizes=subsidises
subsidize=subsidise
subsidizing=subsidising
subtotaled=subtotalled
subtotaling=subtotalling
succored=succoured
succoring=succouring
succor's=succour's
succors=succours
succor=succour
sulfate's=sulphate's
sulfates=sulphates
sulfate=sulphate
sulfide's=sulphide's
sulfides=sulphides
sulfide=sulphide
sulfuric=sulphuric
sulfurous=sulphurous
summarized=summarised
summarizes=summarises
summarize=summarise
summarizing=summarising
swiveled=swivelled
swiveling=swivelling
symbolization's=symbolisation's
symbolization=symbolisation
symbolized=symbolised
symbolizes=symbolises
symbolize=symbolise
symbolizing=symbolising
symmetricly=symmetriccally
sympathized=sympathised
sympathizer's=sympathiser's
sympathizers=sympathisers
sympathizer=sympathiser
sympathizes=sympathises
sympathize=sympathise
sympathizing=sympathising
synchronization's=synchronisation's
synchronizations=synchronisations
synchronization=synchronisation
synchronized=synchronised
synchronizes=synchronises
synchronize=synchronise
synchronizing=synchronising
synthesized=synthesised
synthesizes=synthesises
synthesize=synthesise
synthesizing=synthesising
systematization's=systematisation's
systematization=systematisation
systematized=systematised
systematizes=systematises
systematize=systematise
systematizing=systematising
tantalization's=tantalisation's
tantalization=tantalisation
tantalized=tantalised
tantalizer's=tantaliser's
tantalizers=tantalisers
tantalizer=tantaliser
tantalizes=tantalises
tantalize=tantalise
tantalizingly=tantalisingly
tantalizing=tantalising
tasseled=tasselled
tasseling=tasselling
technicolor=technicolour
teetotaler's=teetotaller's
teetotalers=teetotallers
teetotaler=teetotaller
temporized=temporised
temporizer's=temporiser's
temporizers=temporisers
temporizer=temporiser
temporizes=temporises
temporize=temporise
temporizing=temporising
tenderized=tenderised
tenderizer's=tenderiser's
tenderizers=tenderisers
tenderizer=tenderiser
tenderizes=tenderises
tenderize=tenderise
tenderizing=tenderising
terrorized=terrorised
terrorizes=terrorises
terrorize=terrorise
terrorizing=terrorising
theatergoer's=theatregoer's
theatergoers=theatregoers
theatergoer=theatregoer
theater's=theatre's
theaters=theatres
theater=theatre
theorized=theorised
theorizes=theorises
theorize=theorise
theorizing=theorising
Timor's=Timour's
Timor=Timour
tinseled=tinselled
tinseling=tinselling
tire's=tyre's
tires=tyres
tire=tyre
totaled=totalled
totaling=totalling
totalizator's=totallisator's
totalizators=totallisators
totalizator=totallisator
toweled=towelled
toweling's=towelling's
towelings=towellings
toweling=towelling
toxemia's=toxaemia's
toxemia=toxaemia
trabecule=trabeculae
trammeled=trammelled
trammeling=trammelling
tranquilized=tranquillised
tranquilizer's=tranquilliser's
tranquilizers=tranquillisers
tranquilizer=tranquilliser
tranquilizes=tranquillises
tranquilize=tranquillise
tranquilizing=tranquillising
transistorized=transistorised
transistorizes=transistorises
transistorize=transistorise
transistorizing=transistorising
traumatized=traumatised
traumatizes=traumatises
traumatize=traumatise
traumatizing=traumatising
traveled=travelled
traveler's=traveller's
travelers=travellers
traveler=traveller
traveling's=travelling's
travelings=travellings
traveling=travelling
travelog's=travelogue's
travelogs=travelogues
travelog=travelogue
trialed=trialled
trialing=trialling
tricolor's=tricolour's
tricolors=tricolours
tricolor=tricolour
trivialization's=trivialisation's
trivialization=trivialisation
trivialized=trivialised
trivializes=trivialises
trivialize=trivialise
trivializing=trivialising
trolly's=trolley's
trolly=trolley
troweled=trowelled
troweling=trowelling
tularemia=tularaemia
tumor's=tumour's
tumors=tumours
tumor=tumour
tunneled=tunnelled
tunneler's=tunneller's
tunnelers=tunnellers
tunneler=tunneller
tunnelings=tunnellings
tunneling=tunnelling
tyrannized=tyrannised
tyrannizes=tyrannises
tyrannize=tyrannise
tyrannizing=tyrannising
unappetizing=unappetising
unarmored=unarmoured
unauthorized=unauthorised
unbaptized=unbaptised
uncivilized=uncivilised
uncolored=uncoloured
uncontroled=uncontrolled
underutilized=underutilised
unequaled=unequalled
unfavorable=unfavourable
unfavorably=unfavourably
unfertilized=unfertilised
unflavored=unflavoured
uninitialized=uninitialised
uninstaled=uninstalled
unionization's=unionisation's
unionization=unionisation
unionized=unionised
unionizes=unionises
unionize=unionise
unionizing=unionising
unitized=unitised
unitizes=unitises
unitize=unitise
unitizing=unitising
universalized=universalised
universalizes=universalises
universalize=universalise
universalizing=universalising
unlabeled=unlabelled
unlearned=unlearnt
unorganized=unorganised
unpasteurized=unpasteurised
unpracticed=unpractised
unraveled=unravelled
unraveling=unravelling
unrealized=unrealised
unrecognizable=unrecognisable
unrecognized=unrecognised
unrivaled=unrivalled
unsavory=unsavoury
untrammeled=untrammelled
updraft's=updraught's
updrafts=updraughts
updraft=updraught
urbanization's=urbanisation's
urbanization=urbanisation
urbanized=urbanised
urbanizes=urbanises
urbanize=urbanise
urbanizing=urbanising
uremia's=uraemia's
uremia=uraemia
uremic=uraemic
usability's=useability's
usability=useability
utilizable=utilisable
utilization's=utilisation's
utilization=utilisation
utilized=utilised
utilizes=utilises
utilize=utilise
utilizing=utilising
valor's=valour's
valor=valour
vandalized=vandalised
vandalizes=vandalises
vandalize=vandalise
vandalizing=vandalising
vaporization's=vaporisation's
vaporization=vaporisation
vaporized=vaporised
vaporizer's=vaporiser's
vaporizers=vaporisers
vaporizer=vaporiser
vaporizes=vaporises
vaporize=vaporise
vaporizing=vaporising
vapor's=vapour's
vapors=vapours
vapor=vapour
vapory=vapoury
varicolored=varicoloured
vender's=vendor's
venders=vendors
vender=vendor
verbalization's=verbalisation's
verbalization=verbalisation
verbalized=verbalised
verbalizes=verbalises
verbalize=verbalise
verbalizing=verbalising
victimization's=victimisation's
victimization=victimisation
victimized=victimised
victimizes=victimises
victimize=victimise
victimizing=victimising
victualed=victualled
victualing=victualling
vigor's=vigour's
vigor=vigour
virtualization=virtualisation
visualization's=visualisation's
visualizations=visualisations
visualization=visualisation
visualized=visualised
visualizer's=visualiser's
visualizers=visualisers
visualizer=visualiser
visualizes=visualises
visualize=visualise
visualizing=visualising
vitalization's=vitalisation's
vitalization=vitalisation
vitalized=vitalised
vitalizes=vitalises
vitalize=vitalise
vitalizing=vitalising
vocalization's=vocalisation's
vocalizations=vocalisations
vocalization=vocalisation
vocalized=vocalised
vocalizes=vocalises
vocalize=vocalise
vocalizing=vocalising
volatilized=volatilised
volatilizes=volatilises
volatilize=volatilise
volatilizing=volatilising
vulcanization's=vulcanisation's
vulcanization=vulcanisation
vulcanized=vulcanised
vulcanizes=vulcanises
vulcanize=vulcanise
vulcanizing=vulcanising
vulgarization's=vulgarisation's
vulgarization=vulgarisation
vulgarized=vulgarised
vulgarizer's=vulgariser's
vulgarizers=vulgarisers
vulgarizer=vulgariser
vulgarizes=vulgarises
vulgarize=vulgarise
vulgarizing=vulgarising
wagoner's=waggoner's
wagoners=waggoners
wagoner=waggoner
wagon's=waggon's
wagons=waggons
wagon=waggon
watercolor's=watercolour's
watercolors=watercolours
watercolor=watercolour
weaseled=weaselled
weaseling=weaselling
weatherized=weatherised
weatherizes=weatherises
weatherize=weatherise
weatherizing=weatherising
westernization's=westernisation's
westernization=westernisation
westernized=westernised
westernizes=westernises
westernize=westernise
westernizing=westernising
whiskey's=whisky's
whiskeys=whiskys
whiskey=whisky
willfully=wilfully
willfulness's=wilfulness's
willfulness=wilfulness
willful=wilful
winterized=winterised
winterizes=winterises
winterize=winterise
winterizing=winterising
womanized=womanised
womanizer's=womaniser's
womanizers=womanisers
womanizer=womaniser
womanizes=womanises
womanize=womanise
womanizing=womanising
woolen's=woollen's
woolens=woollens
woolen=woollen
worshiped=worshipped
worshiper's=worshipper's
worshipers=worshippers
worshiper=worshipper
worshiping=worshipping
yodeled=yodelled
yodeler's=yodeller's
yodelers=yodellers
yodeler=yodeller
yodeling=yodelling
