Very well done! A respected Scholar in our medical expert network reviewed your Tip and thinks you are right.	做的非常好！一位受人尊敬的学者在我们的医学专家网络评审了您的小贴士,并认为您的做法是对的。
Very well done! A respected Scholar in our medical expert network reviewed your answer and thinks you are right.	做的非常好！一位受人尊敬的学者在我们的医学专家网络评审了您的答案,并认为您的做法是对的。
Well done! Another doctor in our medical expert network thinks you’re right.	很好！我们的医疗专家网络中的另一位医生认为您是对的。
Continue publishing great posts to help increase your DocScore and distinguish yourself as a leading expert in your community.	请继续在您的社区发表好文章以帮助增加你DocScore和提高自己作为主要专家的区分度。
Continue to provide great tips and answers to help increase your DocScore and distinguish yourself as a leading expert in your community.	请继续在您的社区提供好的小贴士和答案以帮助增加你DocScore和自己作为主要专家的区分度。
Have more to share?	有更多分享？
on a health topic or issue of your choice.	关于您选择的健康主题或问题。
Thanks,	谢谢，
Welcome to HealthTap! We’re so glad you made it. To help you get started, we made a little list of all the things you can do and learn using HealthTap.	欢迎来到HealthTap！我们很高兴您做到了。为了帮助您开始,我们做了您可在HealthTap上做的所有事情和学习使用的一个小列表。
Here we go:	开始：
Ask health questions and get free answers from the best doctors in the country 	提出健康问题，并免费从国内最好的医生获得答案 
Learn about specific health topics with our topics pages	通过我们的主题页面了解具体的健康主题
Prepare for in-person doctor’s appointments and consolidate all your important health information into one safe, secure place by filling out your profile	为准备现场医生的预约,您需要将您所有重要的健康信息合并到一个安全的地方填写你的资料。
Start a private conversation with a specific doctor using HealthTap’s House Calls 	使用HealthTap家庭电话与医生进行私人对话。 
Discover new, highly rated local doctors 	发现新的，被高度评价的当地医生 
Schedule appointments and research practices online	在线安排预约和研究实践
Get started on HealthTap now.	立刻开始使用HealthTap。
Member Guides	会员指南
and get free answers from the best doctors in the country	并免费从国内最好的医生获得答案
Learn about specific health topics with our	与我们一起了解具体的健康主题
Prepare for in-person doctor’s appointments and consolidate all your important health information into one safe, secure place by	为准备现场医生的预约,您需要将您所有重要的健康信息合并到一个安全的地方填写您的资料
with a specific doctor using HealthTap’s House Calls	与一个特定的医生使用HealthTap的House Calls
Schedule appointments and	安排预约和
+2 √points	+2 √积分
Success rate for the prior day's calls for 24 - 48hrs inbox consults	前一天的电话成功率为24 - 48小时收件箱咨询
⌛ [Pending] Doctors with Inbox Consults for 0hrs - 24hrs	⌛ [待定]医生收件箱咨询为0小时 - 24小时
Consult ID	咨询ID
Expert Cell Phone	专家手机
Expert Email	专家邮箱
SYOP ACTIVE	停止活动
Patient ID	患者ID
Inbox Start Time	收件箱开始时间
Inbox Start Time(Expert)	收件箱开始时间（专家）
To Care Team	到医疗团队
is VIP?	是VIP吗？
Inbox Completion Ratio	收件箱完成率
Inbox Success Ratio	收件箱成功率
careteam doctors	护理团队医生
requested doctors	请求医生
⌛ [Pending] Doctors with Inbox Consults for 24hrs - 48hrs	⌛ [待定]医生收件箱咨询为24小时 - 48小时
⌚ [Expired] Doctors with Inbox Consults for 48hrs - 72hrs	⌚ [过期] 医生收件箱咨询为48小时 - 72小时
⌘ Doctors with Real Patient Appointment in Next 24 Hours	⌘ 医生与实际患者预约在接下来的24小时
(who haven't successfully had appointment before)	（以前没有成功预约）
Appointment ID	预约ID
Appointment Time	预约时间
Appointment Time(Expert)	预约时间（专家）
⌘ Doctors Who Already Missed Appointments in Last 24 Hours	⌘ 医生在过去24小时内已经错过的预约
Trophies are awarded to our most engaged doctors on HealthTap. By earning more trophies, you will gain recognition and showcase your expertise and compassion to millions who are seeking your expertise on HealthTap.	奖杯颁发给我们在HealthTap最热爱的医生。赢得更多的奖杯，您会得到认可和向HealthTap上数以百万计的人寻找您专业知识的用户展示您的医者之心。
Happy tapping,	愉快的点击，
By unlocking more medals you will gain recognition and showcase your expertise and compassion.	通过解锁更多的奖牌，您会得到认可，也将展示您的专业知识和同情心。
Quick! Reply in the next two days before this opportunity expires.	快！在此机会过期前两天内回复。
Thanks again,	再次感谢，
Warmly,	温暖地，
3 easy steps to connect to a doctor on your mobile or desktop	3个简单的步骤连接到您的手机或桌面上的医生
Log in to your HealthTap account and select the	登录到您的HealthTap帐户，然后选择
"Ask Docs"	"请求医生"
tab	标签
and get unlimited, immediate doctor consults 24/7	并获得全天24小时无限制的，即刻的医生咨询，
(advice/prescription/checklists, and more!)	（建议/处方/清单，等等！）
Answer a few easy questions to help the doctors provide you with better care, then select	您需要回答一些简单的问题，以帮助医生为你提供更好的护理，然后进行选择
Video, Voice	视频，语音
Text chat.	文字聊天。
You'll be immediately connected with a doctor.	您将立刻连接到一位医生。
It's that easy!	太简单了！
Don’t miss out on HealthTap Prime, our new special service that connects you with top doctors via video or text chat 24/7, for free for 30 days. This special offer is for a limited time only! Start your free trial today and get unlimited 1-on-1 doctor advice, prescriptions, personalized reminders, and much more!	不要错过HealthTap 的黄金会员，我们新的特殊服务，连接您和顶级医生全天24小时通过视频或文字聊天，免费期限为30天。这个特别优惠有时间限制！从您的免费试用期开始，您将获得无限的1对1的医嘱、处方、个性化的提醒和更多！
We’re delighted to offer you a	我们很高兴为您提供一个
our new special service that connects you and your loved ones with a top doctor via video or text chat anytime, anywhere.	我们的新的特别服务，将随时随地连接您和您的亲人与顶级医生通过视频或文本聊天。
Ready to have a health experience that will delight you? Get unlimited advice, prescriptions, and reminders for 30 days for free! Because you’ve already asked a doctor a question on HealthTap, for a limited time we’re thrilled to give you this exclusive offer that’s just for you (not transferable). Sign up today to start your free trial.	准备一个您会喜欢的健康体验？30天内免费获得无限制的建议，处方和提醒！由于您已经在HealthTap上询问了关于医生咨询平台，在有限的时间里，我们只能独家为您提供这个，（不可转让）。立即注册，开始免费试用。
Ready to have a health experience that will delight you? Get unlimited advice, prescriptions, and reminders for 30 days for free! Because you’ve already been such a valued user of HealthTap, for a limited time we’re thrilled to give you this exclusive offer that’s just for you (not transferable). Sign up today to start your free trial.	准备一个您会喜欢的健康体验？30天内免费获得无限制的建议，处方和提醒！由于您已经在HealthTap上询问了关于医生咨询平台，在有限的时间里，我们只能独家为您提供这个，（不可转让）。立即注册，开始免费试用。
Ready to have a health experience that will delight you? Get unlimited advice, prescriptions, and reminders for 30 days for free! Because you’ve kindly thanked a HealthTap doctor for answering your question, for a limited time we’re thrilled to give you this exclusive offer that’s just for you (not transferable). Sign up today to start your free trial.	准备一个您会喜欢的健康体验？30天内免费获得无限制的建议，处方和提醒！由于您已经在HealthTap上感谢了医生回答了您的问题，在有限的时间里，我们只能独家为您提供这个，（不可转让）。立即注册，开始免费试用。
Ready to have a health experience that will delight you? Get unlimited advice, prescriptions, and reminders for 30 days for free! Because you’ve kindly thanked many of our HealthTap doctors for answering your questions, for a limited time we’re thrilled to give you this exclusive offer that’s just for you (not transferable). Sign up today to start your free trial.	准备一个您会喜欢的健康体验？30天内免费获得无限制的建议，处方和提醒！由于您已经在HealthTap上感谢了医生回答了您的问题，在有限的时间里，我们只能独家为您提供这个（不可转让）。立即注册，开始免费试用。
Ready to have a health experience that will delight you? Get unlimited advice, prescriptions, and reminders for 30 days for free! Because you’ve thanked a HealthTap doctor for saving your life, for a limited time we’re thrilled to give you this exclusive offer that’s just for you (not transferable). Sign up today to start your free trial.	准备一个您会喜欢的健康体验？30天内免费获得无限制的建议，处方和提醒！由于您已经在HealthTap上感谢了医生挽救了您的生命，在有限的时间里，我们只能独家为您提供这个（不可转让）。立即注册，开始免费试用。
Ready to have a health experience that will delight you? Get unlimited advice, prescriptions, and reminders for 30 days for free! Because you are a valuable HealthTap user, for a limited time we’re thrilled to give you this exclusive offer that’s just for you (not transferable). Sign up today to start your free trial.	准备一个您会喜欢的健康体验？30天内免费获得无限制的建议，处方和提醒！由于您是我们良好的HealthTap用户，在有限的时间里，我们只能独家为您提供这个（不可转让）。立即注册，开始免费试用。
Ready to have a health experience that will delight you? Get unlimited advice, prescriptions, and reminders for 30 days for free! Because you’ve already asked to get a faster answer to your pressing health question, for a limited time we’re thrilled to give you this exclusive offer that’s just for you (not transferable) so you can get instant advice from one of our top doctors. Sign up today to start your free trial.	准备一个您会喜欢的健康体验？30天内免费获得无限制的建议，处方和提醒！由于您是我们良好的HealthTap用户，在有限的时间里，我们只能独家为您提供这个（不可转让）所以您可以从我们顶级的医生即时的得到意见。立即注册，开始免费试用。
“The doctor can see you now...on your iPhone,” said CNBC. Ready to have a health experience that will delight you? Get unlimited advice, prescriptions, and reminders for 30 days for free! To thank you for your interest in HealthTap, for a limited time we’re thrilled to give you this exclusive offer that’s just for you (not transferable). Sign up today to start your free trial.	“医生可以看到您...在您的iPhone上，”CNBC说。准备一个您会喜欢的健康体验？30天内免费获得无限制的建议，处方和提醒！为了感谢您对于HealthTap的兴趣，在有限的时间里，我们只能独家为您提供这个（不可转让）。立即注册，开始免费试用。
thanked you for your	感谢您的
to their private message.	他们的私人消息。
Continue to provide great answers to help increase your DocScore and distinguish yourself as a leading expert in your community.	请您继续提供好的回答来帮助增加你的Docscore和作为你的社区专家的区分度。
Thanks for Thanking our Doctors - they really appreciate it!	谢谢您感谢我们的医生 - 他们真的很感激！
If you had a great experience please rate our mobile apps here:	如果您有一个很好的体验，请在这里评价我们的移动应用程序：
If you have any suggestions or feedback please reply to this email with your comments.	如果您有任何建议或反馈，请回复此电子邮件与您的意见。
Thanks for letting us know what you think,	感谢您告诉我们您的想法，
thanked you for your post,	感谢您的帖子，
thanked you for your tip on	感谢您的小贴士
thanked you for answering a	感谢您回答了一个
Continue publishing great posts to help increase distinguish yourself as an expert in your community.	请您继续发布好的公告，以帮助增加自己作为社区专家的区分度。
Continue to provide great tips and answers to help distinguish yourself as an expert in your community.	请您继续提供良好的小贴士和回答，以帮助增加自己作为社区专家的区分度。
Details:	详细信息：
SYOP Interested: yes	STOP兴趣：是的
SYOP LEAD: Landing Page	SYOP LEAD: 登录页面
Expert name:	专家姓名：
SYOP LEAD: Concierge Application	SYOP LEAD: Concierge应用
Pricing Package Selected:	选择的价格套餐：
Story Submitted:	提交的故事：
, wants to follow you on HealthTap because they are interested in your practice and clinical expertise.	，想在HealthTap上追随您是因为他们对于您的实践和临床经验有很大的兴趣。
Sign up now to see your new follower. We look forward to welcoming you to HealthTap!	立即注册，查看您的新关注者。我们期待着您来HealthTap！
All the best	祝一切顺利
Since you’ve asked the question	因为您问了问题，
, we’ve received several new related questions and answers that you may find helpful. Take a look:	，我们已经收到了一些新的相关的问题和答案，可能会对您有帮助。看一看：
We know it’s important to stay up-to-date on the health information that matters most to you.	我们知道保持最新的健康信息的更新对您来说是最重要的。
At HealthTap, you get more than just answers to personal health questions; you get relevant trustworthy knowledge you can use.	在HealthTap，您得到的答案远比个人的健康问题要多，您得到相关的可靠的知识都可以被使用。
 to discover related answers, explore relevant topic pages or even follow a doctor who specializes in health subjects that you are most interested in.	 发现相关的答案，探索相关的主题页面，或者甚至关注一个专门从事您最感兴趣的健康主题的医生。
Sign into HealthTap today	立刻登录HealthTap
 to find the information you need from the doctors you trust – they can’t wait to help you!	 您需要向您信任的医生寻求信息－他们迫不及待地想要来帮助您。
Come back to 	回到 
Sincerely,	真诚地，
We've received your question, thanks!	我们已收到您的问题，谢谢！
You asked:	您提问的：
So you’re probably thinking,	所以您可能在想，
“What happens now?”	“现在会发生什么？"
Well your question has been sent to tens of thousands of U.S. licensed doctors, but please be patient. With our recent rapid growth worldwide, new questions are pouring in every second. Don’t fret, the doctors in our network and the HealthTap team are hard at work to provide you with trusted, high-quality answers.	您的问题已被发送给成千上万的美国认证的医生，请您只管耐心。随着我们最近在世界范围内的快速增长，新的问题在每一秒都在涌入。您无需担心，在我们网络医生和咨询平台的团队正在努力工作，为您提供值得信赖的、高质量的答案。
other answers »	其他解答 »
If these questions provide the information you’re looking for, great! If not, we encourage you to	如果这些问题可以提供您正在寻找的信息，那太棒了！如果没有，我们鼓励您
pay it forward and	付款并
browse relevant topics	浏览相关主题
invite your friends	邀请您的好友
while you wait.	当您等待时
Thanks again and happy tapping,	再次感谢并祝您点击快乐，
said:	说道：
We hope you find this information helpful!	我们希望这些信息对您有所帮助！
sent you a post from HealthTap.	从HealthTap向您发送了一条帖子。
HealthTap provides health information and answers from thousands of doctors licensed in the United States. Anytime. Anywhere.	HealthTap提供健康信息，并成千上万的从美国执照医生那获得答案。任何时间。任何地点。
For free.	免费。
To see the message,	查看信息，
now.	现在。
To your health!	为您的健康！
see attachment	查看附件
 please reply with unsubscribe	 请回复以取消订阅
Comprehensive expert compensation report	全面的专家薪酬报告
Have fun with the report. Please get Karan any/all of the following to show your appreciation: 	有乐趣的报告。请获得Karan以下任何的/所有的，以表示您的赞赏： 
Customers  .	顾客  .
Thank you for helping others as a HealthTap Scholar.	谢谢您作为一名HealthTap学者对他人的帮助。
Here's a summary of your activity last week:	以下是您上周的活动摘要：
Your Weekly Summary	您的每周总结
Your Activity on Questions	在问题中您的活动
Questions returned	返回问题
since last week	自从上周以来
Questions deleted	已删除问题
Your Activity on Answers	在解答中您的活动
Answers agreed	解答已同意
Answers featured	解答已特写
Review Questions	回顾问题
Review Answers	评论答案
As a Scholar you are among the top doctors on HealthTap, and play a vital role in our community as a key contributor and as an "expert among experts."	作为一名学者，您是HealthTap的顶级医生之一，并在我们的社区作为主要贡献者和“专家专家”发挥至关重要的作用。
Maintain your status as a Scholar	保持您作为学者的身份
Dr. Geoffrey Rutledge, M.D., Ph.D.	Geoffrey Rutledge医生, M.D., Ph.D.
drrutledge@healthtap.com	DrRutledge@healthtap.com.
Hello,	您好，
I'm always trying to improve patient-care and provide a better experience for you. As my patient, I value your health and well-being, and would really appreciate you spending 2 minutes to share your thoughts on my practice and your overall health.	我一直在努力提高对于患者的护理，并为您提供更好的经验。作为我的患者，我看重您的健康和幸福，并感谢您花2分钟来真正分享我的做法和您整体健康的想法。
Thank you,	谢谢您，
Reporter	报告
Reason	理由
Reported Person	报告人
Reported Content	报告内容
Reason:	理由：
Reported:	报告：
Welcome to HealthTap, your new interactive Medical Home,	欢迎来到HealthTap，您的新互动医疗之家，
where you can get broad recognition for your expert knowledge (by effortlessly distributing the content you create via social media),	在这里，您可以为您的专家知识获得广泛的认可（毫不费力地分配您通过社交媒体创造的内容），
find new patients and grow your practice, and reduce your costs while improving the quality of care.	寻找新的患者，并增加您的实践，降低成本，同时提高护理质量。
Get started in 3 simple steps:	从3个简单的步骤开始：
Confirm your account:	确认您的账户：
2. Complete your registration by updating your public profile and entering 3 simple Answers or Tips to become a Featured Medical Expert	2.您可以通过更新您的公众形象完成您的注册和提供个3简单的答案或小贴士成为特色医疗专家。
3. Advance your online reputation and improve the quality of care by entering additional Answers and Tips to your Medical Home	3.您需要提高您的在线声誉和护理质量，通过额外的答案和小贴士，优化您的医疗家园。
Here's more information:	这里有更多的信息：
1. Confirm your account details here:	1.在这里确认您的账户详细信息：
Please note: Registration requires a photo (under 4MB) for your HealthTap profile.	请注意：注册您的HealthTap个人资料需要照片（4MB以下）。
If you do not have one available, please select one from our gallery.	如果您没有合适的，请从我们的图库中选择一个。
Real photos help build credibility and trust with users.	真实照片有助于提高可信度和获得用户的信任。
2. Complete Your Registration	2.完成注册
by Updating Your Profile and Answering three or more Questions	通过更新您的个人资料以及回答三个或更多问题
It's fast and simple to update your interactive Medical Home on HealthTap and be recognized by patients in your town and nationwide.	在HealthTap上更新您的交互式医学家园是快速和简单的，也可以被更多患者广为人知。
Getting started as a Medical Expert is easy: just post 3 or more short Answers (which can be as brief as a sentence or two – you can edit or delete them at any time)	一开始作为一个医学专家是很容易的：只需张贴3张或更多的简短的答案（这可能是简短的一句或两句，您可以在任何时间编辑或删除它们）
then complete your registration by updating the information on your Medical Home - select "Medical Home" from your home page and add your personal information to the About section.	然后完成您的注册，通过从您的主页更新您的医疗主页上的信息-选择“医疗主页”，并添加关于您个人信息的部分。
You have full control over everything you share on HealthTap and can use your insights in your	您对于在HealthTap上公开的一切都有权控制，并且可以使用您的见解在您
own blog, website, and in other publications. You can automatically syndicate your posts on other	自己的博客，网站和其他出版物。您可以自动将您的帖子加入其他
social media platforms. Our staff would be happy to set up professional Facebook or Twitter	社交媒体平台。我们的工作人员将很乐意为您设置专业的Facebook或Twitter
accounts for you (for free).	帐户（免费）。
3. Advance your online reputation	3.提高您的线上声誉
by adding simple Answers and Tips	通过添加简单的解答和小贴士
Advance your online and social media reputation by sharing your answers and Tips on HealthTap.	通过在HealthTap上公开您的回答和小贴士来提高您的在线声誉和公众医学名望。
For a limited time, our most prolific contributors can achieve Founding Expert status and be prominently featured on our founding experts page.	在有限的时间内，我们最丰富的贡献者可在我们的创始专家页实现创始专家的地位，并突出特色。
Additionally, to appear as a Featured (5+ answers), Notable (25+ answers), or Leading (50+ answers) Expert,	此外，以出现作为一个精选（5 +答案），显着（25 +答案），或领先（50 +答案）的专家，
simply provide more quality responses to questions and add more Tips on HealthTap.	仅仅需要给问题提供更多专业的回答，在HealthTap上增加更多的小贴士
All Answers and Tips you post will link back to your Medical Home Page. You can broaden your visibility by contributing more content,	您发布的所有答案和小贴士都将链接到您的医疗首页。您可以通过提供更多内容来拓展您的知名度，
which will also help new patients find you. Your Medical Home can also serve as a valuable resource for your existing patients, before and between visits.	这也将帮助新的患者找到您。在您访问之前和访问之间，医疗中心也可以作为您现有患者的宝贵资源。
We're here to help	我们在这里为您提供帮助！
If you have any questions, or if you would like any assistance getting started, email	如果您有任何问题，或者您想要得到任何帮助，请给我们发送邮件
or call us at (650) 644-1833. Our medical and technical staff are standing by to help at anytime.	或拨打电话(650) 644-1833。我们的医疗和技术人员随时等待帮助您。
Alan	Alan
Alan Greene, MD, FAAP	Alan Greene, MD, FAAP
HealthTap Medical Director and Physician Community Lead	HealthTap医学主任和医师社区领导
https://www.healthtap.com/expertnetwork	https://www.healthtap.com/expertnetwork
Thanks for using HealthTap – we hope you've had an amazing experience so far! We're hard at work to make sure that you enjoy a real 5-star experience.	感谢使用HealthTap，我们希望您有个开心的体验！我们正在努力工作，以保证您享受真正的5星级体验。
Give us 5-stars!	给我们5星！
If HealthTap has been helpful to you in your search for trusted health information, we'd appreciate you helping others who need us find us like you did by	如果HealthTap在您搜索可信健康信息时有所帮助，我们非常感谢您帮助其他人找到我们通过
rating HealthTap highly on iTunes App Store.	在iTunes App Store上高度评价HealthTap。
rating HealthTap highly on Google Play.	在Google Play上高度评价HealthTap。
It only takes a few seconds to submit your rating, and positive reviews would help others try HealthTap and get the same great service you did.	将不会花您很多时间给我们评级，积极的评论将有助于其他人尝试HealthTap并得到同样好的的服务。
Have feedback?	有反馈吗？
If you you have some direct feedback on where we can improve even more  - please feel free to reply to this email - as we're very committed to constantly providing a better service to our users and will welcome your suggestions.	如果您觉得我们有可以改进的地方，请随时回复此电子邮件，因为我们致力于不断地为我们的用户提供更好的服务，并欢迎您的建议。
★★★★★ Rate HealthTap 5-stars today »	★★★★★ 立刻给HealthTap 5星好评 »
Many thanks and wishing you good health and smiles,	非常感谢并祝您身体健康和天天开心，
We know you’ve been waiting a while for an answer to your question, and we’d like to thank you for your patience. We just want to let you know that not all questions on HealthTap receive answers. A question is likely to go unanswered if it lacks detail, the question is unclear, or if it contains terms with which the doctors are not familiar. We are writing to let you know that your question is much more likely to receive a response if you improve it by editing or resubmitting it.	我们知道您为了回复已经等了一段时间，感谢您的耐心等待。我们只是想让您知道不是所有在HealthTap的问题都能得到答案。如果一个问题不详细，问题不清楚，或者如果包含了医生不熟悉的术语，那么这个问题可能不会得到答复。我们致函让您知道，如果您通过编辑或重新提交问题来改进问题，您的问题将更有可能收到回复。
We encourage you to look at relevant information for your question and use it to improve your question. You’ll find an amazing amount of questions and existing answers on HealthTap.	我们鼓励您查看您的问题的相关信息来改善您的问题。您会在HealthTap上找到大量的问题和现有答案。
See Similar Questions and discover related topics:	查看相似的问题并发现相关主题：
With our huge database of questions and health topics, chances are you’ll find something similar. We encourage you to look through similar questions to find the answer you’re looking for.	有了我们庞大的问题和健康主题数据库，您会发现类似的情况。我们鼓励您通过寻找类似问题找到您想要的答案。
After you review similar content, we suggest you	在您查看类似的内容后，我们建议您
to add enough detail to make it meaningful, answerable, and easy to understand. Please remember to only ask about one topic in your question, and double-check your spelling and grammar.	通过添加更多的细节使问题更有意义，可被答复并简单易懂。请记住只询问您的问题中的一个主题，并仔细检查您的拼写和语法。
Thanks for editing your question! We know it will help us find you the answer you’re seeking.	谢谢您编辑您的问题！我们知道这将帮助我们找到您寻找的答案。
We know you’re still waiting on an answer and want to thank you for your patience. Our doctors are still working overtime to answer the questions pouring in from across the globe. We really want to help you find the answer you’re looking for and we encourage you to take one of the following actions to improve your chance of finding a great answer from a top doctor:	我们知道您还在等待答案，感谢您的耐心等待。我们的医生仍在加班，以回答来自全球各地的问题。我们真的想帮助您找到您想要的答案，我们鼓励您采取以下行动之一从而提高您从专家医生那得到答案的机会：
Review Similar Content:	回顾相似的问题：
With our huge database of millions of questions and answers from leading doctors, chances are you’re likely to find similar questions that already have great answers from multiple doctors, that were peer reviewed by other doctors too!	有了我们庞大数百万的问题和医生给出答案的数据库，您很可能找到类似的问题并且已有多个医生由其他医生同行评审的答案！
See related topics »	查看相关主题 »
Did the content on these pages answer your question?	这些网页上的内容是否能解答您的问题？
Edit your question:	编辑您的问题：
If you don’t find an answer you’re 100% happy with by looking at similar questions on HealthTap, feel free to edit and improve your question.  Our doctors are able to select which questions to answer, and may skip questions that aren’t answerable, clear, and/or detailed.  Ways to improve your question include: add enough detail to make it meaningful, answerable, and easy to understand; ask about just one topic in your question; and double-check your spelling and grammar.	如果您通过看HealthTap上的类似问题没有找到100％满意答案，请随时修改和改进您的问题。我们的医生能够选择回答哪些问题，可能会跳过很难回答，不清晰和/或不详细的问题。改善您的问题的方法包括：添加足够的细节使其有意义，可回答和易于理解; 只问一个和问题相关的主题; 并仔细检查您的拼写和语法。
Expedite for only $0.99:	加速只需$ 0.99：
If you’d like to get your question answered faster, you can also donate 99 cents to charity and we’ll give your questions a higher priority.	如果您想更快地得到答案，您可以捐赠99美分给慈善机构，我们会给您的问题更高的优先权。
Thanks for asking!	谢谢提问！
As you know, our doctors are currently working through many great questions from millions of people everywhere. We really want to help you find the answer you’re looking for so we encourage you to take one of the following actions to get a great answer from a top doctor faster:	如您所知，我们的医生目前正在处理来自数百万人的问题。我们真的想帮助您找到答案，所以我们鼓励您采取以下行动之一以更快地从顶级医生得到答案：
With our huge database of millions of questions and answers from leading doctors, chances are you’re likely to find similar questions that already have great answers that were even peer reviewed by other doctors!	有了我们庞大数百万的问题和医生给出答案的数据库，您很可能找到类似的问题并且已有多个医生由其他医生同行评审的答案！
With new answers created every second, we encourage you to check out other answers that our system thinks are similar to yours.	每一秒都会新的答案，我们鼓励您查看系统认为与您类似问题的其他答案。
Thanks for your patience!	谢谢您的患者！
and distinguish yourself as a leading expert in your community.	并将自己区分为您所在社区的领先专家。
ExpertSupport@healthtap.com	ExpertSupport@healthtap.com
If you would like to know more about finding patients in your area, we'd be happy to help! Please contact us directly at 	如果您想了解更多关于您所在地区的患者信息，我们很乐意为您提供帮助！请直接联系我们通过 
A HealthTap user is waiting for an answer to this question on a topic we thought might interest you:	HealthTap用户正在等待我们认为您可能感兴趣的主题的问题的回答：
As always, please send any questions, comments or feedback to 	与往常一样，请发送任何问题，意见或反馈 
Reaching out to members in your area is a great way to find new patients and gain recognition in your community. Connecting with local patients on HealthTap will provide you the opportunity to suggest an in person appointment, and will allow you to keep track of their health and wellbeing.	接触您所在地区的会员是找到新患者并在您的社区获得认可的好方法。在HealthTap上与当地患者联系将为您提供面对面给别人建议的机会，并允许您跟测他们的健康。
It appears your HealthTap profile is still incomplete. You can quickly add to it gain and even more visibility in front of millions of patients and colleagues who are looking for your expertise on all mobile devices and web channels.	这里显示您的HealthTap档案仍然不完整。您可以快速添加它获得，甚至更多的可见性在数百万移动设备和网络渠道上寻求您的专业知识的患者和同事面前。
If you have any questions about how to improve your DocScore, we'd be happy to help! Please contact us directly at 	如果您有任何关于如何提高您的DocScore的问题，我们很开心能够帮助您！请直接联系我们通过 
If you wish to no longer receive this kind of email from HealthTap, please just	如果您不喜欢收到任何来自HealthTap的此类邮件，
let us know.	请告诉我们。
We’re excited to share that starting today you’re qualified to get our Premier services of faster answers and longer questions for free!	我们很开心地通知您，从今天起，您有资格免费获得我们的黄金会员服务以得到更快的答案和更长的问题
Share HealthTap with loved ones and friends and get our “Premier” status while helping them access the best doctors and most trusted health information.	与亲人和朋友分享HealthTap，获得我们的“黄金会员”身份，同时帮助他们访问最好的医生和最可信的健康信息。
When 3 of your loved ones or friends sign up to HealthTap, we’ll show our appreciation with a free	当您的三个亲人或朋友注册HealthTap，我们将我们的感谢您并且您有一次免费咨询的机会。
expedited answer	快速答复
(faster response) or	(更快的回复) 或
50 extra characters	50个额外字符
for your question!	为您的问题！
When 10 of your friends sign up to HealthTap, we’ll show even more appreciation with a	当十个您的亲人或朋友注册HealthTap，我们将感谢您并且您
month of unlimited questions	一个月内将有无限咨询的机会。
with expedited answers or 50 extra characters!	更快的获得答案或有50个额外字符。
Getting Premier Status is easy: all you have to do is invite your friends to HealthTap via email, SMS, Facebook, Twitter, and Google+  and copy/paste the following unique link into the invitation:	获取黄金会员身份很简单：您只需通过电子邮件，短信，Facebook，Twitter和Google+邀请朋友加入HealthTap，并将以下链接复制/粘贴到邀请中：
By sharing HealthTap with loved ones and friends, you can get faster, more detailed answers from our doctors and help make our world a healthier, happier place.	通过与亲人和朋友分享HealthTap，您可以从我们的医生获得更快，更详细的答案，并帮助使我们的世界变成更健康，更快乐的地方。
ASK A QUESTION TODAY!	立刻询问一个问题
Boost your DocScore, build more patient loyalty, and serve your patients better by inviting them to join you on HealthTap.	通过邀请他们加入您的HealthTap，提高您的DocScore，建立更多的患者忠诚度，更好地为您的患者服务。
You have a special opportunity to send real-time practice updates to your patients on HealthTap and get appointment requests online. Additionally we will notify you when your patients ask questions on HealthTap so you can stay up-to-date on their Health Activity and provide them with meaningful answers.	您有特殊的机会在HealthTap上向您的患者发送实时实践更新，并在线获取预约请求。此外，当您的患者在HealthTap上提出问题时，我们会通知您，以便您可以及时了解他们的健康活动并提供有意义的答案。
If you have any questions about inviting and interacting with your patients on HealthTap, we'd be happy to help! Please contact us directly at 	如果您有任何关于在HealthTap上邀请并与您的患者互动的问题，我们很乐意帮助您！请直接联系我们通过 
We suggest changing the password to your own in your	我们建议您一登入账户就将密码
as soon as you log into your account. If you would like additional assistance accessing HealthTap, please contact HealthTap Support at support@healthtap.com.	更改为自己的密码。如果您有任何额外的帮助进入HealthTap, 请联系HealthTap。具体信息在support@healthtap.com
Trending questions	热门问题
Colleagues you may know	您可能知道的同事
Add to network	添加到网络
News for you	为您的新闻
New questions for you	为您的下一个问题
total	总共
Your Network Activity This Week	本周您的网络活动
Your DocScore	您的DocScore
Your shared insights	您分享的见解
Peer review	同行评议
here's your week in review	这里是您的周检查
Let’s get you set up to see your patients virtually. "It's easy; the first step is to take the quick self-guided training tutorial; It only takes a few minutes. "	让我们设置怎样虚拟地看到您的患者。这很容易; 第一步是看快速自我指导训练教程; 它只需要几分钟。“
Note: the self-guided tutorial is only available on your computer web browser.	注意：自学教程仅在您的电脑网络浏览器上可用。
Have questions? Want more support? We'd love to help!	有问题吗? 想要更多支持？我们很乐意帮助！
Best,	最好的，
Dr Damian Tomic	Damian Tomic医生
Clinical Director Primary and Integrated Care	临床主任和综合护理
The tutorial will walk you through a simulated virtual consult and system functionality and should take about 10-15 minutes, and needs to be completed on a computer (not an iPhone or iPad Pro). The tutorial must be completed prior to conducting any live consultations to ensure you understand important aspects of online consulting etiquette as well as testing your PC for video consulting.	本教程将引导您完成模拟虚拟咨询和系统功能，需要大约10-15分钟，需要在电脑（不是iPhone或iPad Pro）上完成。教程必须在进行任何现场咨询之前完成，以确保您了解在线咨询礼仪以及测试您的PC的视频咨询。
Please add this website to your “favourites” by selecting the star icon at the top right of your web browser.	请通过选择网络浏览器右上方的星形图标将此网站添加到您的“收藏夹”。
Once logged in, you can access your tutorial while in HealthTap below:	登录后，您可以在下面的HealthTap中访问您的教程：
Kind regards,	亲切的问候，
Kat	Kat
Kathryn Swart	Kathryn Swart
Project Coordinator – The Virtual DHB	项目协调员 - 虚拟DHB
Email: virtualhealth@waikatodhb.health.nz  |  Mobile: 0277-855-621	邮箱：virtualhealth@waikatodhb.health.nz  |  手机: 0277-855-621
This is your final reminder to complete your tutorial. Your self-guided tutorial shows you what it looks like to receive a Virtual Consult from a patient. Be prepared when a real patient needs you, and take a few minutes now and complete the training to be a virtual care expert.	这是您完成个人指导的最后提醒。您的自学指南将向您展示从患者那里获得虚拟咨询的样子。当真正的患者需要您时，准备好，现在需要几分钟，完成培训，成为一名虚拟护理专家
Kate Yeo	Kate Yeo
Associate Director of Nursing	护理副主任
Virtual Health and Older Persons	虚拟健康和老年人口
You can also access the tutorial anytime by logging into your account on a computer and clicking the tutorial link in the top right:	通过在电脑上登录您的帐户，您可以随时访问教程，然后点击右上角的教程链接：
Darrin	Darrin
Darrin Hackett	Darrin Hackett
Executive Director of Virtual Care and Innovation	虚拟护理和创新执行董事
Waikato DHB	Waikato DHB
Ruth	Ruth
FACEM FDRHM	FACEM FDRHM
Clinical Director Thames Hospital	Thames医院临床主人
Emergency Physician Waikato Hospital	Waikato Hospital急救医师
Did you know that	您知道吗
virtual care is the best way for you to provide the right care at the right time and place?	虚拟护理是您在正确的时间和地点提供适当护理的最佳方式？
Without commute or waiting room delays, your patients get to talk to you when they need you most and you get to provide more convenient, effective care.	没有通勤或等待房间延迟，当他们最需要您时，您的病人将与您谈话，您提供更方便，有效的护理。
To make it easier for you to learn about delivering the best care, there is a short interactive tutorial for you once you login!	为了让您更容易了解如何提供最好的护理，一旦您登录就有一个简短的互动教程！
If you have any questions or issues, please contact our Customer Care Team at	如果您有任何问题或疑问，请联系我们的客户医疗团队
thevirtualdhb@healthtap.com.	thevirtualdhb@healthtap.com.
offer your patients a new and convenient access to healthcare.	为您的患者提供一种新的，方便的医疗保健
HealthTap is the world’s first Health Operating System, allowing	HealthTap是世界上第一个健康操作系统，允许
doctors in large health systems to provide virtual, end-to-end care to more	医生在大型健康系统中提供虚拟的端到端护理对更
effectively manage patient populations.	有效管理患者人群。
Claim your account	立刻声明您的帐户
today and have the ultimate flexibility. HealthTap HOPES is the solution doctors and	并且拥有极致的灵活性。HealthTap HOPES是各地医生和
patients everywhere have been waiting for!	病人都在期待的解决方案！
voice, and text chat, helping	视频，和文字聊天，帮助
optimize your day-to-day practice by decreasing patient wait times and improving your efficiency.	通过减少患者的等待时间和提高效率来优化您的日常实践。
Setting your password	设置您的密码
is a major step towards setting up your Virtual Practice!	是建立您的虚拟实践的一个重要步骤！
Once you’ve set your password, you can start seeing your patients virtually.	一旦您设置了密码，您可以开始虚拟看到您的患者。
Studies show that doctors who participate in virtual care are able to help more patients,	研究表明，参与虚拟护理的医生能够帮助更多的患者，
stay better informed about medical procedures and medications, and are	保持更好的医疗程序和药物的了解，以及
overall more satisfied with the type of care they can provide.	总体上对他们可以提供的护理类型更满意
Join us in the healthcare revolution and help improve access to high-quality healthcare around the world!	加入我们的医疗改革，并帮助改善世界各地的高质量医疗保健服务！
or at the	或在
Here are 5 reasons why you should	这里有5个原因为什么您应该
claim your account:	声明您的帐户：
Join us in improving access to high-quality healthcare!	加入我们，改善获得高质量医疗保健的途径！
Virtual consults allow you to do all of the following and more:	虚拟咨询允许您执行以下所有操作：
Immediately connect with a board certified doctor anytime on any device	随时在任何设备上立即连接一个美国认证医生
Get personalized reminders, tips, news, and health apps.	获取个性化提醒，小贴士，新闻和健康应用
MALE	男
FEMALE	女
YEARS	年
Vanessa Hernandez	Vanessa Hernandez
Quality Care Specialist	质量保证专员
Dr. Jay Wohlgemuth	Jay Wohlgemuth医生
Chief Healthcare Officer	首席医疗官
Isaac Weaver	Isaac Weaver
Dr. Geoffrey Rutledge, MD, PhD	Geoffrey Rutledge医生, MD, PhD
The HealthTap Compass Team :)	HealthTap指南针团队:)
Your password should be 6+ characters.	您的密码应为6个字符以上。
Your temporary password is:	您的临时密码是：
You may	您可以
change your password	更改您的密码
at any time.	随时。
Offer ends in fifteen days.	优惠将在十五天内结束。
HealthTap respects your privacy. To change your email notifications,	HealthTap尊重您的隐私。更改您的邮件通知
By signing up you agree to HealthTap's	通过注册，您同意HealthTap的
If you have any questions, please contact your Account Manager.	如果您有任何问题，请与您的客户经理联系。
from general emails in your Account settings tab under	从您的帐户设置标签下的常规电子邮件
. You will still receive notifications regarding account activity.	.您仍会收到有关帐户活动的通知
We respect your privacy. To change your email notifications,	我们尊重您的隐私。更改您的邮件通知
Practice on a world-class, query-to-cure health platform	在一个世界级的，查询到治疗的健康平台的实践
Connect with patients from any mobile device or personal computer	从任何移动设备或个人计算机连接患者
Provide advice, prescriptions, and order and review lab tests	提供建议，处方和订单，并审查实验室测试
Provide medical advice and diagnosis through virtual consults	通过虚拟咨询提供医疗建议和诊断
Hands-on help making and sticking to healthy habits	亲自动手帮助制作和坚持健康的习惯
Access to doctors 24/7 for prescriptions, lab tests, and referrals	全天24小时访问医生获得处方，实验室测试和转诊
Advice, tips, and checklists to help you meet your health goals	建议，小贴士和清单以帮助您实现您的健康目标
What HealthTap Compass can do for you:	HealthTap Compass可以为您做：
Access doctors whenever you need them for prescriptions, lab tests, and referrals	每当您需要处方，实验室测试和转诊时请访问医生
Get advice, tips, and checklists to help you meet your health goals	获得建议，小贴士和清单，以帮助您实现您的健康目标
It’s for your entire family	这是为您的整个家庭
I’m delighted to share with	我很高兴与您分享
you a new valuable health service	一个新的有价值的健康服务
If you’ve ever had a health question but didn’t have the time/energy/money to find the right doctors, make appointments, and wait in waiting rooms, you probably turned to the Internet. Unfortunately, much of the information out there is neither personalized, nor easy to trust.	如果您有健康问题，但没有时间/精力/金钱找到合适的医生，预约，等候房间，您可能转向了互联网。不幸的是，在那里的许多信息既没有个性化，也不轻易信任。
By signing up today	立即通过注册
to your new health portal, you can get immediate access to personalized and trustworthy health advice and answers from top doctors 24/7 from anywhere using your smartphone, tablet, PC, or mobile device. You can get medical advice, prescriptions, lab test ordered and reviewed, referrals and more!	到您的新的健康门户，您可以使用您的智能手机，平板电脑，PC或移动设备随时从任何地方立即获得个性化和可信的健康建议和解答从最高的医生。您可以获得医疗咨询，处方，实验室测试订购和审查，转诊和更多！
It’s fast and easy to get started–so take a minute and	它快速，容易上手，所以需要一分钟
sign up today	立即注册
so you can access your new healthcare navigator when you need it most.	当您最需要它时，您可以访问您的新医疗导航器
today!	今天！
and benefit today and gain ultimate peace of mind for you and your loved ones.	并今天受益，并为您和您的亲人赢得安心。
All you need is a smartphone, tablet, PC, or smartwatch. Now is your time to feel fantastic and enjoy true peace of mind!	您所需要的只是一个智能手机，平板电脑，电脑，现在是您的时间感觉奇妙，享受真正安宁的内心！
it provides you with	它提供给您
convenient access to top doctors and their wisdom and care— anytime, anywhere!	方便的访问顶级医生和他们的智慧和护理 - 随时随地！
begin your journey toward health and happiness	开始您的健康和幸福的旅程
—join today!	—立即加入!
Now you can access	现在您可以随时随地访问
world-class healthcare anytime, anywhere!	世界级的医疗！
immediate answers to your health 24/7.	全天24小时立即回答您的健康
It's FREE!	免费！
Sign up today.	立即注册
An award-winning global leader in digital health HealthTap provides convenient, compassionate, and immediate answers to your health needs from Query to Cure.	一个屡获殊荣的数码健康全球领导者HealthTap为您的健康需求提供方便，同情和即使的答案从查询到治疗。
TAP IN!	点击！
The HealthTap Team :)	HealthTap团队 :)
With just the touch of a button	只需点击一个按钮
you and your family will be immediately connected with top doctors  without the hassle of traveling to a doctor's office or spending time in a waiting room. You can get medical advice, prescriptions, lab tests ordered and reviewed, and much more!	您和您的家人将立即与顶级医生联系，而无需前往医生办公室或在等候室消磨时间。您可以获得医疗咨询，处方，实验室测试订购和审查，以及更多！
Start saving time and money today—all you need is a computer, smartphone, tablet, or smart-watch.	今天开始节省时间和金钱 - 所有您需要的是一台电脑，智能手机，平板电脑或智能手表。
Tap in to the wisdom	点击智慧
Did you know it takes three weeks to make or break a habit? Whether you want to lose weight, eat healthier, or reduce stress, our top doctors can help.	您知道吗，需要三个星期才能打破习惯？无论您想减肥，吃得更健康，还是减轻压力，我们的顶级医生可以帮助。
It’s easy to use, and proven to be efficient in helping people manage their health and well being, and achieve their health goals. Receive the care and support you and your family need right from your mobile device or personal computer.	它易于使用，并被证明能有效地帮助人们管理他们的健康和幸福，并实现他们的健康目标。从您的移动设备或个人计算机接收您和您的家人需要的照顾和支持。
Sign up today and enjoy:	立即注册，享受：
activate your account here	请在此处激活您的帐户
HealthTap Prime is your new healthcare hub for managing all your health needs: Enjoy access to top primary care doctors for online virtual consultations right from your phone or computer for convenient and trustworthy healthcare at your fingertips. Within minutes you can connect to a top doctor and get medical advice, prescriptions, lab test ordered and more!	HealthTap Prime黄金会员是您新的医疗中心，用于管理您的所有健康需求：您可以从您的手机或计算机访问普通门诊医生在线虚拟咨询，方便可靠的医疗保健在几分钟内，您可以连接到一个顶级医生并得到医疗咨询，处方，实验室测试订购和更多！
HealthTap is a globally recognized, award-winning new way to manage health and well-being— we’re dedicated to helping you live a healthier, happier life. Activate your account and start feeling great today!	HealthTap是一个全球公认的，获奖的新方式来管理健康和幸福 - 我们致力于帮助您的生活更健康更快乐。激活您的帐户，并从今天开始就感觉很好！
Want to feel fantastic?	想要感受不可思议？
HealthTap is a globally recognized award-winning new way to manage health and well being, providing you the right care at the right time from Query to Cure.	HealthTap是一个全球公认的屡获殊荣管理健康和幸福的新方式，为您在正确的时间从查询到治疗提供正确的护理。
Most importantly, we care about you—and we want you to feel good every day –	最重要的是，我们关心您 ——我们希望您每天都很好——
tap in and start feeling great today.	点击并从今天开始就感觉很好。
sign up and start feeling great today.	注册并从今天开始就感觉很好！
Now is the time to start making your New Year health resolutions come true!	现在是开始使您的新年健康决心成真的时候了！
simply select your goal today!	只需选择您的目标！
Whatever your goals are, our doctor-created checklists are here to make you smile and feel good!	无论您的目标是什么，我们的医生创建的清单在这里，让您微笑和感觉良好！
What are you waiting for?	那么您还在等什么？
Tell us what health topics and goals matter to you!	告诉我们对您重要的健康主题和目标！
To receive personalized tips, answers, recommended health apps, customized health news (and more), simply	要接收个性化的小贴士，答案，推荐的健康应用程序，自定义健康新闻（和更多），简单
complete your private profile today!	完成您的私人个人资料！
To ensure you are provided with the health information you need when you need it most, take a minute to update your private profile on HealthTap – add allergies or medical conditions you have, and any medications you take. Your information is always confidential, safe, and secure.	为确保您在需要时获得最需要的健康信息，请花一点时间在HealthTap上更新您的个人资料 - 添加过敏或医疗状况，以及您服用的任何药物。您的信息是保密的和安全的。
We want to help you feel fantastic!	我们想要帮助您感受到不可思议！
Please take a minute to confirm your location	请花一点时间确认您的位置
so we can connect you within minutes to the right doctors via video, voice or text when you need them most.	所以当您最需要他们时我们可以通过视频，语音或文字，几分钟内连接到正确的医生。
tell our doctors a little bit about yourself	告诉我们的医生关于您自己的一点信息
Be proactive, not reactive.	是主动的而不是被动的
Take a minute to provide some basic personal information to help enable our network of more than 82,000 top doctors provide you with the right care, when you need it most.	当您最需要它时，花一点时间提供一些基本的个人信息来帮助我们超过82,000顶级医生为您提供正确的护理。
by telling us a bit about yourself.	通过告诉我们一点关于您自己的信息。
Your new HealthTap account is convenient and easy to use, and provides:	您的新HealthTap帐户方便，易于使用，并提供：
To help doctors help you, please provide some basic information about yourself. HealthTap is private, confidential, and completely secure.We look forward to helping you feel fantastic!	为了让医生帮助到您，请提供一些关于您自己的基本信息。HealthTap是私人，保密，完全安全。我们期待着让您有十分良好的感觉！
Don’t waste a moment worrying about a health issue—get immediate advice and answers to your most pressing healthcare needs from Query to Cure by	不要浪费时间担心健康问题——您最迫切的医疗保健需求得到即时的从查询到治疗的建议和答案
HealthTap saves you:	HealthTap保存您：
No need to take time off from work to go to the doctor’s office—all you need is a smartphone, tablet, PC, or smartwatch	无需离开工作去医生的办公室 - 所有您需要的是一个智能手机，平板电脑，电脑或智能手表
Worries	担忧
Get immediate peace of mind even in the middle of the night with immediate access to doctors on call	请立即安心，即使在半夜，随时可以访问在值的医生
At HealthTap,	在HealthTap，
we believe that access to quality healthcare is a fundamental human right.	我们认为获得高质量的医疗服务是一项基本人权
We also believe that everyone deserves the right care, at the right time.	我们还认为，每个人都应该在适当的时间得到正确的照顾。
You have access to doctors, who can get you:	您可以访问医生，谁可以让您：
We want to give you the very best care! That’s why you should complete your	我们会给您最好的护理！这就是为什么您应该完成您的
HealthTap profile.	HealthTap个人资料
Adding information about allergies or any pre-existing conditions will help our doctors help you even more, so complete your profile now!	添加有关过敏或任何预先存在的条件的信息将有助于我们的医生帮助您更多，所以现在完成您的个人资料！
you want. Too many people put off seeing a doctor until they’re really sick, but recovery costs more,	您想要。太多的人推迟看医生，直到他们真的病了，但恢复的花费更高，
and takes more time, than prevention.	并且比预防需要更多的时间。
to get convenient and immediate answers to your health concerns 24/7. You’ll get world-class healthcare	全天候为您的健康问题以获得方便快捷的解决方案。你会得到世界级的医疗保健
from Query to Cure powered by HealthTap, an award-winning global leader in digital health, and our	从查询到治疗由HealthTap，一个屡获殊荣的全球数码健康领导者和我们的
Be proactive and engage in your personal health—ask your questions early and often to save time and to live a longer, happier life.	积极主动，并参与您的个人健康 - 提前和经常提出您的问题，以节省时间，并生活更长，更快乐的生活。
We want you to have access to high-quality, world-class healthcare so you can feel good now! When it comes to	我们希望您能获得高品质，世界一流的医疗保健，所以您现在可以感觉很好！当
searching on the Internet, just three clicks can turn a minor ache or pain into a serious condition.	在互联网上搜索，只需点击三次可以使轻微的疼痛或疼痛变成严重的状况。
A general web search isn’t the best way to get credible health information.	一般的网络搜索不是获取可信的健康信息的最佳方式。
and get a real, caring physician to help clarify all of your health concerns from Query to Cure.	并得到一个真正的，有爱心的医生帮助您查清所有从查询到治愈的健康问题。
All you need is a smartphone, tablet, PC, or smartwatch to start feeling fantastic!	所有您需要开始一个奇妙的感受的是一部手机，平板电脑，电脑或者智能手表！
Get peace of mind by knowing you’ll always have:	通过知道您将会有的这些得以安心：
A doctor-created knowledge base of health information	医生创建的健康信息知识库
The right care, at the right time	在合适的时间的合适的护理
Real-time doctor consults whenever you need them	无论何时您需要他们，实时的医生可以咨询
Whatever goal you have—to maintain a healthy weight, eat better,	无论您有什么目标 - 保持健康的体重，吃得更好，
Doctors on HealthTap have created health action plans for health and wellness goals that you are interested in. Follow a checklist on HealthTap to receive reminders (via email or mobile push notification) that will help you to stay on track.	HealthTap的医生为您感兴趣的健康目标制定了健康行动计划。按照HealthTap的清单接收提醒（通过电子邮件或移动推送通知），这将有助于您保持健康。
Follow a checklist on HealthTap to receive reminders, via email or mobile push notification, that will help you to stay on track.	按照HealthTap的清单接收提醒，通过电子邮件或移动设备推送通知，将帮助您保持在正轨。
Doctors on HealthTap have created	HealthTap上的医生创建
health action plans,	健康行动计划，
including ones for:	包括用于：
compassionate and comprehensive care when you need it most. You also have access to your	当您最需要它时，同情和全面的照顾将会给您您也可以访问您的
doctor-curated feed made up of health answers, tips, news and more!	医生策划的新闻订阅是由健康答案，小贴士，新闻和更多组成的！
Doctor answers you need for yourself and your loved ones	医生回答了您为自己和您的亲人的需要
Access to doctors on any computer or mobile device	在任何计算机或移动设备上访问医生
Live video, voice, and text chat with doctors from anywhere	与任何地方的医生实时视频，语音和文本聊天
you manage your family’s health in addition to your own?	除了您自己，您管理您的家人的健康？
a HIPAA-compliant, safe, and secure place to enter all the	一个兼容HIPAA标准，安全可靠的地方进入所有的
medical and health information for your partner and dependents.	医疗和健康信息为您的伴侣和家属
Take advantage of these family-friendly features by	利用这些适合家庭的功能
completing your HealthTap profile!	完成您的HealthTap个人资料！
You can track your family’s immunization and health records, privately ask questions on their behalf,	您可以跟测您家庭的免疫接种和健康记录，私下询问他们的问题
and schedule doctor consults for them anytime, night or day.	并为他们安排医生咨询随时，夜间或白天。
No matter what your health question is, chances are that a HealthTap doctor has already answered it.	不管您的健康问题是什么，有可能是一个HealthTap的医生已经回答了的问题。
If you don’t find an answer that helps, you can immediately talk to a caring, compassionate doctor, 24/7.	如果您没有找到有帮助的答案，您可以随时立即与一个有关怀心同情心的医生谈话。
All communications are secure, HIPAA-compliant, and private so only you and your doctors see your health	所有谈话都是安全的，兼容HIPAA的，并且是私人的，所以只有您和您的医生看到您的健康
information. Follow topics, search for answers, and ask questions of your own!	信息。关注主题，搜索答案，并提出自己的问题！
Instead,	相反，
get immediate, credible information on thousands of health topics—created just for you by top doctors.	获得关于成千上万个有关健康主题的即时，可信的信息 - 由顶级医生为您创建。
You can follow any health topic and check your personal news feed for updates—all from your smartphone, tablet, PC, or smartwatch.	您可以关注任何健康主题，并检查您的个人新闻订阅的更新 - 所有从智能手机，平板电脑，电脑或智能手表。
healthcare needs met in one place from any computer or mobile device.	医疗保健需求在从任何计算机或移动设备的一个地方。
Don’t let your health concerns linger. Go ahead and ask top doctors!	不要让您的健康问题停留。去问问顶级的医生！
Now is a great time to assess how far you’ve come and follow up with any potential leads.	现在是一个很好的时间来评估您跟进任何潜在的潜在客户的程度。
If you haven’t yet already, follow up with your warm leads by sending them one, two, or all three videos in the marketing kit—all based on real-life HealthTap use cases:	如果您还没有，通过发送他们的一个，两个或所有三个在市场工具包里的视频 - 所有基于现实生活HealthTap用例跟踪您的温暖的潜在客户：
In addition we suggest you reach out to at least 5 more groups in order to start the conversation.	此外，我们建议您与至少5个群组联系，以便开始对话。
Have you considered social media? It’s an excellent way to amplify your messaging and share it with a wider audience.	您考虑过社交媒体吗？这是一个很好的方式来扩大您的消息，并与更多的观众分享。
You can post on social media platforms like Twitter, Facebook, and LinkedIn. Make sure to add your special URL generated from	您可以在社交媒体平台上发布，如Twitter，Facebook和LinkedIn。请务必添加您生成的特殊网址
You should also use the	您也应该使用
image assets	形象资产
Before the week ends, post on each of the three main social media platforms: Twitter, Facebook, and LinkedIn.	在本周结束之前，发布在三个主要的社交媒体平台上：Twitter, Facebook, 和LinkedIn.
We hope the	我们希望
marketing kit,	营销工具包，
widget, and flyers, have helped you increase your exposure and sales.	小工具和传单，帮助您增加您的曝光和销售。
For only $XX a month/$XX annually, get unlimited virtual consults with a primary care physician anytime, anywhere (you set your client’s monthly or annual price)!	只需$ XX一个月 / $ XX一年，随时随地（可根据客户的月度或年度价格）与普通门诊医生进行无限的虚拟咨询！
Make sure your clients know these value props by emailing and calling them this week.	确保您的客户通过电子邮件和打电话来了解本周这些有价值的道具。
Did you know there’s an easy, no-email, no-phone call way to drive business?	您知道有一个简单，没有电子邮件，没有电话的方式来推动业务吗？
All you need to do is paste a bit of HTML code in your blog or website to create a widget.	所有您需要做的是在您的博客或网站上粘贴一点HTML代码来创建一个小工具。
Your clients can click on the widget and make a purchase!	您的客户可以点击小工具，并进行购买！
First, enter your Group size, Price per person and your email address	首先，输入您的群组大小，每人价格和您的电子邮件地址
here,	这里，
and click Submit. Please note that if you want to drive sign ups for individuals,	和点击提交。请注意，如果您想驱动个人注册，
(in which case one person pays and give access to the whole group). Once generated, copy and replace the green copy below with the URL.	（在这种情况下，一个人支付可以允许整个组访问）。生成后，请复制并替换在网址下面的绿色副本。
160 x 600 Widget	160 x 600 小工具
250 x 250 Widget	250 x 250 小工具
728 x 90 Widget	728 x 90 小工具
Now you can drive clients to your website to click and purchase HealthTap Prime through your personalized widget. Try it today, add the widget to your website and share your website link with your clients!	现在，您可以让客户到您的网站，点击您的个性化小工具购买HealthTap Prime黄金会员资格。立即尝试，将小工具添加到您的网站，并与您的客户分享您的网站链接！
Prefer a more offline approach?	喜欢更离线的方法吗？
Print	打印
this flyer for groups	为小组的传单
or this one	或这个
for individuals	为个人
and share it with your clients in-person.	并亲自分享给您的客户。
If you need help or have any questions please email the Strategic Advisor Support Team at	如果您需要帮助或有任何问题，请通过电子邮件联系战略顾问支持团队在
We hope you enjoyed browsing the	我们希望您喜欢浏览
marketing kit!	营销工具包！
Whether you’re selling to groups or individuals, the marketing kit has everything you need to succeed.	无论您是向团体或个人销售，营销工具有成功所需的一切。
We highly recommend starting by sending your group clients the	我们强烈建议您首先发送您组里的客户
HealthTap Prime one-pager for groups	HealthTap Prime为小组的简要介绍
HealthTap Prime Introduction Deck for groups.	HealthTap Prime为小组的入门层次
Try sending them to 5 groups this week to get the	尝试在本周将他们发送给5组并获得
conversation started. We’ve also found that adding	会话已开始。我们还发现添加
images	图像
in the body of an email and using compelling	在电子邮件的正文并使用引人注目的
language in the subject line helps close clients!	语言在标题栏有助于亲密的客户！
If you have any questions or want more tips on	如果您有任何问题或者想要更多的小贴士
growing your book of business, email the	成长您的公司日记账，发邮件到
Strategic Advisor Support Team at	战略顾问支持团队
Use the following credentials and log in	使用以下证书并登录
to access your exclusive HealthTap Prime user account for live demos or share this demo video.	访问您的独家HealthTap Prime黄金会员用户帐户的即时演示或分享此演示视频。
com	com
healthtap	healthtap
@	@
Email: janesmith+brokerdemo	邮箱：janesmith+brokerdemo
Password: healthtap1	密码： healthtap1
You can also use	您也可以使用
this pre-recorded video	这个预先录制的视频
to show your clients how easy it is to immediately connect with doctors and get medical advice, prescriptions, lab test ordered and reviewed, and much more!	向您的客户展示如何轻松地立即与医生联系，并获得医疗咨询，处方，实验室测试订购和审查，以及更多！
If you have any questions or want more tips on growing your book of business email our	如果您有任何问题或想要更多关于增长您的商业预定的小贴士，邮件我们的
We’re committed to helping you succeed!	我们致力于帮助您取得成功！
Within the next few weeks, we will be providing you with tips and insights to empower you to effectively sell	在接下来的几周内，我们将为您提供小贴士和见解，帮助您有效地销售
HealthTap Prime to your clients and grow your book of business.	HealthTap Prime黄金会员为您的客户并增加您的业务预定。
To start, take a look at the	首先，看看
available to you. Here’s what’s in it:	您可用的。这里有什么：
The marketing kit is a great tool to help you plan your business strategy. As always, you can email our Strategic Advisor Support Team at	营销工具是一个伟大的工具可以帮助您规划您的业务战略与往常一样，您可以电子邮件我们的战略顾问支持团队
if you have any questions.	如果您有任何问题。
Introduce your friends and family to HealthTap and help them live healthier, happier lives. For every person you refer, you’ll both receive $5 in credit.	介绍您的朋友和家人到HealthTap，并帮助他们更健康，更快乐的生活。对于您介绍的每个人，您都将获得$ 5的信用。
Share now!	立刻分享！
You can start exploring our rich trove of health services by confidentially asking any health question and getting a free answer from one of our more than 60,000 top doctors—often within minutes!	您可以通过秘密地要求任何健康问题开始探索我们丰富的健康服务，并得到超过60,000其中一个顶级医生的免费答案 - 通常在几分钟内！
With our premium service, HealthTap Prime you can consult a doctor anytime, anywhere using real-time high-definition video, audio, or text chat. As a welcome gift we would like to offer you a 15-day FREE trial of Prime.	通过我们的优质服务，HealthTap 黄金会员您可以随时随地使用实时高清视频，音频或文字聊天咨询医生。作为一个欢迎的礼物，我们愿意为您提供一个15天免费试用黄金会员的机会。
You can start exploring our rich trove of health services by confidentially asking any health question and getting a free answer from one of our more than 60,000 top doctors—often within minutes! Or, consult a doctor at anytime from anywhere using real-time high-definition video, audio, or text chat.	您可以通过秘密地要求任何健康问题开始探索我们丰富的健康服务，并得到超过60,000其中一个顶级医生的免费答案 - 通常在几分钟内！或者，随时随地使用实时高清晰度视频，音频或文字聊天咨询医生。
Start your 15-Day FREE Trial today!	立即开始您的15天免费试用！
Feel free to start exploring HealthTap now!	立刻免费开始探索HealthTap！
Only 28 days left on your HealthTap Prime free trial! Start today, and gain even more reasons to smile and feel good! Now you can take advantage of all the wonderful things we offer.	您的HealthTap Prime免费试用只剩28天！从今天开始，并获得更多微笑和感觉很好的理由！现在您可以利用我们提供的所有美好的东西。
In addition to the benefits that all members get, Premium members get:	除了所有会员获得的好处，黄金会员获得：
Sign up for a HealthTap Prime membership	注册成为一名HealthTap Prime会员
today, and gain even more reasons to smile and feel good! Now you can take advantage of all the wonderful things we offer.	从今天，并获得更多微笑和感觉很好的理由！现在您可以利用我们提供的所有美好的东西。
with doctors 24/7 using a PC or any mobile device!	使用电脑或任何移动设备随时与医生！
Total peace of mind	完全的放心
with a doctor always "on call" for you and your loved ones	为您和您的亲人与时常当值的医生
Health checklists personalized by doctors	医生个性化的健康清单
just for you or your family	只为您或您的家人
Prescriptions, referrals, and more	处方，转诊等
Want fewer emails?	想减少电子邮件吗？
Suggested Doctors for You	为您推荐的医生
Connect with these top specialists for you to build your 24/7 doctor Care-Team	与这些顶级专家联系为您建立您的全天候医生医疗团队
Follow us for more	关注我们获得更多
Give your friends and family a FREE month of Prime - and get $30 off for every person who joins!	给您的朋友和家人免费一个月的黄金会员 - 每个加入的人并得到$ 30的折扣！
Get help from a doctor now via video or text chat	立即通过视频或文字聊天获取医生帮助
shared news	分享新闻
What difference did HealthTap make in your life?	HealthTap在您的生活中有什么区别？
here's your	这里是您的
Here's your	这里是您的
here's your Prime	这里是您的Prime
Here's your Prime	这里是您的Prime
Doctor Consults at a 55% discount	医生咨询享受55％的折扣
Buy now, use later, or share with family	立即购买，以后使用或与家人分享
Limited-time offer!	限时优惠！
created	已创建
Doctors available to help you	医生可以帮助您
Access the world's leading online knowledgebase	访问世界领先的网上的知识库
of doctor-created health information. We're	的医生创建的健康信息。我们
committed to helping you feel good!	致力于帮助您感觉良好！
Get beautiful, bite-sized tips of health information	获得美丽的，很小的健康信息小贴士
created by doctors, personalized for you.	医生为您创建的个性化。
Take action to achieve your health goals	采取行动实现您的健康目标
with our proprietary, customizable doctor-created checklists!	与我们专有的，可定制的医生创建的清单！
Keep your health records accessible, private, and secure	保持您的健康记录可访问，私密和安全
so that you can easily share them with doctors to get better care whenever necessary.	所以如有必要，您可以轻松地与医生分享他们，以获得更好的护理。
Isaac and the HealthTap Team	Isaac和HealthTap团队
Get faster, on-the-go access to doctors with our	获得更快的，随时随地的访问我们的医生
top rated	评分最高
in 128 specialties from expected private practices and top institutions, like Cleveland Clinic and Harvard to discover how simple and rewarding it is to get featured in front of millions. 	在128个从期待的私人实践和顶级机构的专家，如克利夫兰诊所和哈佛，在百万人面前去发掘如何简单和有价值得到新功能。 
today and	今天和
Enhance your reputation as a nationally recognized Top Doctor 	提高您作为国家公认的顶尖医生的声誉 
Attract new local patients in need of your expertise	吸引需要您专业知识的新本地患者
Grow your referral network from our 1.2 million doctor directory	从我们的120万医生名单中增加您的咨询网
to help you and your practice thrive on our popular platform that NBC, CBS, the New York Times, and the Wall Street Journal have featured as the leading digital healthcare solution for doctors. 	去帮助您和您的实践在我们流行的平台上蓬勃发展，NBC，CBS，纽约时报和华尔街日报已经为医生领先的数字医疗解决方案起着重要方案。 
It's free and takes just a minute to	它是免费的，只需1分钟
Please send me email or call me at the number below if you have any questions, or if I can be of help in any way.	如果您有任何问题，或者如果我能以任何方式帮助，请给我发电子邮件或打电话给我。
In good health, 	身体健康， 
Geoffrey W. Rutledge MD, PhD	Geoffrey W. Rutledge MD, PhD
Chief Medical Information Officer	首席医务信息官
 Team	 团队
Share on Facebook	分享到Facebook
Share on Twitter	分享到Twitter
Send us feedback	发送反馈给我们
You've got the reason to smile.	您有理由微笑。
Founder and CEO	创始人兼CEO
Wishing you good health and smiles from the entire	祝您身体健康和天天开心。
HealthTap Team :)	HealthTap团队 :)
We respect your privacy. To change your email notifications	我们尊重您的隐私。更改您的邮件通知
Download the free mobile app!	免费下载移动应用程序！
Congratulations on taking this first step as a pioneer in digital health! After this tutorial,	恭喜您为数码健康的先驱迈出第一步！本教程后，
you will be able to deliver virtual consults to your patients anytime, anywhere.	您将能够随时随地向您的患者提供虚拟咨询。
Complete:	完成：
Wishing you health and happiness,	希望您健康开心，
Irina and The HealthTap Team	Irina和HealthTap团队
Expert ID:	专家ID：
Expert Full Name:	专家全名：
Expert Email:	专家邮箱：
Expert Location:	专家地址：
Expert DocScore:	专家DocScore：
Expert Speciality:	专家专业：
Non-Network Expert ID:	非网络专家ID：
Non-Network Expert Full Name:	非网络专家全名：
Non-Network Expert Email:	非网络专家邮箱：
Non-Network Expert Phone:	非网络专家手机：
Non-Network Expert Fax:	非网络专家传真：
Session	会话
Patient ID:	患者ID：
Platform	平台
Flagged Consult - Incorrect Patient Info	标记的咨询 - 不正确的患者信息
Doctor ID:	医生ID：
Doctor Name:	医生姓名：
Consult ID:	咨询ID：
Consult Location:	咨询位置：
Consult Time:	咨询时间：
Relevant Text:	相关文字：
Server	服务
Expert application phone number	专家应用电话号码
for expert with email:	联系专家通过邮箱：
Contact Numbers:	联系电话：
Best Time To Call:	最佳呼叫时间：
Uploaded File	已上传的文件
Expert has issue with plugin!	专家的插件有问题！
Expert Name:	专家姓名：
HTUID:	HTUID:
Expert's Phone Number:	专家的手机号码：
Shifts with incomplete attendance last 24 hours	过去24小时内未完成出勤的班次
Total incomplete attendance for this shift last 6 months	过去6个月这个班次的未完成出勤总数
Total incomplete attendance last 6 months	最近6个月的未完成出勤总数
Shifts with missed calls last 24 hours	过去24小时转接的未接来电
Total missed calls for this shift over 6 months	6个月内这次班次的未接来电总数
Total missed calls over 6 months	6个月内的未接来电总数
Aseem	Aseem
This portal is incredibly easy to use, and will benefit your practice in many ways. Take a moment to login today!	这个门户网站是令人难以置信的易于使用，并将在许多方面有利于您的实践。立刻花一点时间登陆！
You'll reduce your practice's scheduling burdens and ad-hoc questions from patients,	您将减少您的实践的安排负担和患者专门的问题
while providing patients with trusted information between doctor visits and the best	同时为患者提供医生访视之间的可信信息和最好的
Simple scheduling with automatic appointment reminders	带有自动预约提醒的一般日程安排
Your doctor can see patients from anywhere, at anytime, from any device and offer more continuous care	您的医生可以在任何时间为来自各地、各个服务器的患者看病，并且提供较持续的护理。
Your doctor gets paid for care they already give outside of office visits	对于工作时间以外的护理，医生需收取费用。
Stay up to date with the latest information in your field	随时了解您所在领域的最新信息。
Your feedback is very important to us.	您的反馈对我们很重要。
Do good · Do well · Feel good	做好 · 做得好 · 感觉很好
To invite others to join this private consult, share this link and ask them to visit it once the appointment starts:	要邀请其他人加入此私人咨询，请分享此链接并要求他们在预约开始后访问：
New resume	新的简历
email:	邮箱：
message:	信息：
Hi team,	您好，团队，
A user just unsusbcribed from healthtap:	刚刚从healthtap取消订阅的用户：
A new group	一个新的小组
has been created	已经被创造了
Group description:	小组简介：
New contact us message	新的联系我们的客户
id:	id:
from:	从：
subject:	主题：
The question was:	问题是：
You answered:	您已回答：
Your answer may have been flagged by your colleagues for reasons such as:	您的回答可能已由您的同事标记，原因如下：
Being too short to be helpful	太简短无法提供帮助
Being far off the topic asked	偏离了提问的主题
Using overly technical words or abbreviations	过多使用技术词语或缩写
Being hard to understand due to spelling or grammar issues	因为拼写或语法问题而难以理解
Having a tone or text that surely would hurt the patient’s feelings	一种肯定会伤害患者感情的口气或表达
Referring to unusual ideas not supported by the medical community	据不被医学界支持的非寻常想法
Sending the patient to another website without answering his question	将患者送到另一个网站，而不回答他的问题
Being commercial or self-serving in nature	商业或自我服务
You may view our Reference Guide on How To Write a Great HealthTap answer below.	您可以查看我们关于如何在下方书写HealthTap网站答案的参考指南。
Your new answer will immediately be published to regular circulation again, where all patients and experts can see it.	您的新答案将立即公布，再次定期发行，所有患者和专家都可以看到它。
Everybody on HealthTap loves great questions and awesome answers.  Please take a moment to read your own answer one last time before submitting.  Members and colleagues will be grateful.  Happy Tapping!	HealthTap上的每个用户都喜欢好的问题和极好的答案。请在提交之前花一点时间最后一次阅读您自己的答案。会员和同事会非常感激。愉快的点击！
Thanks again for your participation,	再次感谢您的参与，
HealthTap Scholars Team	HealthTap学者团队
Reference Guide: How to Write a Great HealthTap Answer	参考指南：如何写一个优秀的HealthTap答案
Do not provide medical care through HealthTap.  HealthTap is a website, not a doctor, and therefore is not a substitute for your face-to-face professional medical advice, diagnosis rendering, and treatment of disorders.  Write your answers mainly to give information.	不要通过HealthTap提供医疗治疗。HealthTap是一个网页，不是医生，因此不能替代您面对面的专业医疗建议，诊断和病症的治疗。根据信息写您主要的答案。
Too direct:	太直接：
You have jock itch, so buy some OTC Lotrimin cream and use it twice a day for 2 weeks.  Keep your groin dry, and your rash should be gone in a couple of weeks.	您有股癣，所以买一些非处方的Lotrimin霜（ 一种抗真菌药品牌，通用名是克霉唑），每天两次涂用，为期2周。保持您的腹股沟干燥,您的皮疹应该在几周内消失。
Much better:	更好一点：
Itchy, reddened, slightly flaky skin in the groin skin folds can be from jock itch or other causes.  Jock itch (tinea cruris) is caused by a fungus germ, and is usually treated with over-the-counter Lotrimin AF cream or with prescription anti-fungal medication from a doctor.	腹股沟处的皮肤瘙痒，发红，轻微片状可能是由股癣或其他原因所致。股癣（一种癣）是由真菌引起的，通常用非处方Lotrimin AF霜或医生开的抗真菌的处方药物进行治疗。
Add a personal touch to your answer to humanize the online interaction.	在您的回答上添加一个个人触感，使您的在线互动人性化。
Examples:	例如：
Include a hint of humor if appropriate; wish the member “good luck”, “have a great day”, or “hope you get well soon”; or add a comforting picture or image.	在适当情况下，网站会带有一丝幽默; 希望会员“好运”，“有美好的一天”，或“希望您很快好起来”; 或添加令人欣慰的图片或图像。
Make your answer long enough to be helpful to others, because thousands of people all over the world may read your answer. Answers of less than 4 words are bad answers (just imagine the member sitting, facing you, and only hearing 4 words from you).	让您的答案充分到足以帮助他人，因为世界各地的成千上万的人可能会看到您的答案。小于4个字的答案不是好的答案（您就想象有个会员面对着您坐着，却只听到您说的的4个字）。
Too brief:	太简洁：
Do another pregnancy test.	做另一个怀孕测试。
If a first over-the-counter (OTC) urine pregnancy test is negative, but a woman really feels that she is pregnant, she can do another OTC urine pregnancy test one week later.	如果第一次非处方（OTC）尿妊娠试验呈阴性，但一个女人真的觉得她怀孕了，她可以在一周后再做一次OTC尿怀孕测试。
Put some details in your answer.  Details help members understand their problems.	在您的答案中提出一些细节。详细信息可以帮助会员了解他们的问题。
Adequate:	充足：
Eat foods that have few calories.	吃具有少量热量的食物。
One should eat foods that have few calories such as carrots, celery sticks, and iceberg lettuce; but use no salad dressing or only a bit of low-calorie dressing.	人们应该吃具有少量热量的食物，例如胡萝卜，芹菜杆和卷心莴苣; 但不能食用沙拉酱或只食用一点低热量的调味品。
Consider adding a picture or other image to your answer, to emphasize your point, help explain a fact, or just make your answer more appealing.	考虑将图片或其他图片添加到您的答案，强调您的观点，帮助解释一个事实，或只是让您的答案更具吸引力。
Example:	例如：
Add a picture of an ambulance when informing a member that the usual recommendation, for people with the symptoms he asks about, is to go to an Emergency Room.	添加一张救护车的图片，当通知一个会员，通常的建议，对于有问题的人，是去一个急诊室。
Use the most widely known drug name, or use both the brand and generic names, when talking about medications.	当谈到药物时，请使用最广为人知的药物名称，或使用品牌和通用名称。
One may try acetaminophen but see the doctor if fever persists.	可以尝试对乙酰氨基酚，但如果仍发烧不退，请就医。
One may try Tylenol (acetaminophen) or Motrin/Advil (ibuprofen) if the fever is not high, but should see a doctor if fever goes higher or lasts more than 2 days.	如果发烧不高，可以尝试泰勒诺（药名）（对乙酰氨基酚）或布洛芬/艾德维尔（布洛芬），但如果发烧升高或持续超过2天，应该去看医生。
Use good grammar and punctuation, reflecting the many years of a doctor's higher education.	正确使用语法和标点符号，反映出医生受了多年的高等教育。
Poor form:	差的回答：
A person can hurt their arms if you do too many reps too much weight or bad technique	如果您重复做负重过大的动作或没掌握技巧时，您的手臂可能会受伤。
A person can hurt his arm muscles by doing too many repetitions, using too much weight, or having poor weight-lifting techniques.	当一个人重复多次做负重过大的举重动作时，或举重技巧不对时就使手臂肌肉受伤。
Don't assume every HealthTap member speaks English well or has a higher education.  Explain long words and avoid medical abbreviations.	不要默认每个HealthTap会员都很会讲英语或接受过高等教育。解释长单词且避免使用医学缩写。
Not good:	不太好：
The G.I. doc may order fecal occult blood x3 to screen for colon ca.	G.I. doc可以根据大便潜血x3筛选结肠癌。
The gastroenterologist (stomach/intestines specialist) may order a stool test to check for traces of blood in the stool, on 3 separate days, to look for signs of colon cancer.	胃肠病学家（胃/肠专家）可以在3个不同的日期进行粪便试验以检查粪便中的血液的痕迹，以寻找结肠癌的迹象。
Thanks for being a contributor on HealthTap.  Colleagues have indicated that there may be a problem with an answer you agreed with by clicking the AGREE button.	感谢您成为HealthTap的贡献者。同事表示，您通过点击AGREE按钮表示同意的答案可能会存在问题。
The answer may have been flagged by your colleagues for reasons such as:	答案可能已被您的同事标记，因如下原因：
Going forward, we recommend keeping these guidelines in mind when "agreeing" with your colleagues' answers. Patients and doctors will appreciate your discretion at highlighting only the highest quality medical information!	展望未来，我们建议在“同意”您的同事的回答时，牢记这些准则。患者和医生将感谢您对强调最高质量的医疗信息的审慎态度！
Here are some of the latest:	这里有一些最新的：
Thanked you for your	感谢您的
Answer to	回答
Well done!	很好！
recommended you.	推荐您。
Thanks for providing such high quality information and support here on HealthTap!	感谢您在HealthTap上提供如此高质量的信息和支持！
Gift of Health	健康的礼物
I’m happy to share with you that I've found a great new simple and free way to help you live a healthier happier life, and for us to stay connected between visits. Very soon, you will start receiving from me a weekly HealthTap newsletter filled with great pearls of wisdom and beautiful pictures that can help you keep healthy living top of mind.	我很高兴与您分享我发现的一个极佳的的新的简单又免费的方式，以帮助您有一个更健康的幸福的生活，这个方式也能我们在访问中保持联系。很快，您会开始收到我的每周HealthTap通讯，其中充满了大量的智慧的珍珠和美丽的图片，可以帮助您保持健康的生活头脑。
The newsletter will come from my Virtual Practice on HealthTap - a free web and mobile service that allows you to ask health questions, receive daily health tips, and benefit from the world’s most trustworthy and useful health information written by yours truly and some of the best doctors in the US.	该通讯将来自HealthTap上我的虚拟实践——一个免费的网络和移动服务，让您提问健康问题，接收每日健康小贴士，并收益于世界上最可靠和有用的健康信息，这些信息由您忠实的医生所写，其中有一些是美国最好的医生。
To send you this newsletter, I have added you to my Patient Directory on HealthTap. By adding you to this list, your Health Profile will be visible to me. At any time, you can remove me as ‘Your doctor’ on my	为了向您发送此通讯，我已将您添加到HealthTap上的我的患者目录。通过将您添加到此列表，我可以看见您的健康档案。在任何时候，您都可以将我从您的「您的医生」页面移除。
page. If you prefer not to receive health information and tips from me in this newsletter, you may	页。如果您不希望在本通讯中收到我的健康信息和小贴士，您可以
If you are not interested in receiving the newsletter,	如果您不想收到通讯，
Welcome to Healthtap!	欢迎来到HealthTap！
Here are a few ways you can make the	这里有几种方法，
most out of HealthTap for free!	您可以充分利用免费的HealthTap！
questions	问题
and get free answers from the best doctors in the country.	并免费从国内最好的医生获得答案。
Get useful	获得有用的
beautiful tips	美丽的小贴士
written by doctors for you daily.	医生为您每天写的。
health topics	健康主题
for conditions, symptoms, treatments, and more.	用于健康状况，症状，治疗等。
Find top	查找顶部
and discover new, highly rated local ones.	和发现新的，被高度评价的当地医生。
Have any questions or concerns?	有任何问题或担忧吗？
Send us an email and we'll help you	给我们发送电子邮件，我们会帮助您
Welcome! To get started, here are a few ways	欢迎！开始，这里有几种方法
you can make the most out of HealthTap:	您可以充分利用HealthTap：
You've successfully completed your application to participate in the Medical Expert Network on HealthTap. Thanks for applying!	您已成功完成您在 HealthTap网站上参加HealthTap的医疗专家网络的申请。感谢申请！
All applications go through a thorough review process which includes a check on credentials, background and medical licensing. Bear with us as we complete this process. We'll let you know if we have any questions for you and we'll definitely inform you as soon as you're completely approved.	所有应用程序都要经过彻底的审查过程，包括检查凭证，背景和医疗许可。与我们一起完成这个过程。如果我们对您有任何问题，我们会通知您，并且一定会在您完全获得批准后立即通知您。
If you are still logged into your first session on HealthTap, you may continue to answer questions and build on certain aspects of your new Virtual Practice while you await final approval. Once logged out, you will not be able to log back in until your verification process has been completed - usually in about 24 hours.	如果您仍然登录到HealthTap上的第一个会话，您可以在等待最终批准时，继续回答问题，并完善您新的虚拟实践上的某些方面的内容。退出后，您必须在验证过程完成后才能重新登录——通常在大约24小时后。
If you ever find yourself needing any help at all, please let me know. You can reach me directly by sending a message to drrutledge@healthtap.com or by	如果您发现自己需要任何帮助，请告诉我们。您可以通过发送消息到drrutledge@healthtap.com直接联系我或通过
calling (650) 644-1833.	拨打电话(650) 644-1833。
I look forward to seeing you on HealthTap!	我真的很期待在HealthTap上看到您！
Dr. Geoffrey Rutledge, Director, Medical Expert Network	Geoffrey Rutledge医生，医学专家网络主任
We haven’t been this close to the edge of our seats since the last Oscar night. Now, we realize that it was obvious right from the start that it would go to you. Really, who else was there?	自从上一次奥斯卡之夜以来，我们还没有如此接近我们座位的边缘。现在，我们意识到，从一开始它明显会走向您。真的吗，还有谁在那里？
There are hundreds of HealthTap awards that help you show off your skills to patients. Keep winning!	HealthTap网站有数百个奖励，能让您的病人看见您高超的技能。保持胜利！
Congrats!	恭喜！
What's next?  We'll send out an invitation and notify the doctor that they have a question waiting for them.  If you know this doctor, you can encourage them to sign up!	下一步是什么？我们会发出邀请，并通知医生他们有问题正等着他们。如果您了解这个医生，您可以鼓励他们注册！
In the meantime, you can try to schedule an appointment with one of the thousands of doctors already on HealthTap today.	在此期间，您可以尝试与今天在HealthTap上的成千上万的医生中的以为安排预约。
Congrats! You have a new appointment request from a patient. Here are the details:	恭喜！您有来自患者的新的预约请求。详细信息如下：
Name:	姓名：
Scheduling Preferences:	安排首选：
To see the user-provided nature of this appointment request and any files that have been uploaded in connection with this,	要查看此约会请求的用户提供的性质以及与此相关的已上传的任何文件，
What’s next?	下一步是什么？
Call this patient to schedule or confirm the details of this appointment.	呼叫此患者以计划或确认此约会的详细信息。
Agreed with your	同意您的
HealthGuide	HealthGuide
Have you ever found yourself asking other moms about pregnancy or children's health? Have you ever wished someone could validate those opinions? What if some of the moms you asked were also doctors?	您有没有向其他妈妈询问有关怀孕或儿童的健康的事情？您是否一度希望有人能证实那些意见？如果您问的那些妈妈当中也有医生呢？
With HealthTap you can now connect directly with a doctor who's also a loving mom for an answer based on her first-hand experience. Doctor Moms have raised children of their own and can provide a special perspective:	使用HealthTap，您现在可以直接与一位同时也是个慈爱的妈妈的医生联系，以获取基于她的第一手经验的回答。医生妈妈亲自养育自己的孩子，她们可以提供一个特别的视角：
Empathetic, compassionate, and caring insights	有感情的，同情和关怀的见解
Deeper insights into women's issues	深入了解妇女的问题
Are you a parent or parent-to-be? Have you ever had questions about your partner's pregnancy or child's health?	您是父母还是准父母？您有没有关于您的伴侣怀孕或孩子的健康的问题？
HealthTap’s new Doctor Mom gives parents and parents-to-be the opportunity to direct questions to some of our best doctors who in their “free time” are full-time mothers too. Doctor Moms have raised children of their own and can provide a special perspective:	HealthTap的新医生妈妈给父母和准父母 一个直接向我们最好的医生提问的机会，这些医生在“空闲时间”也是是全职妈妈。医生妈妈亲自养育自己的孩子，她们可以提供一个特别的视角：
Are you a parent or parent-to-be? Have you ever had questions about pregnancy or children's health?	您是父母还是准父母？您有没有关于您的伴侣怀孕或孩子的健康的问题？
HealthTap’s new Doctor Mom gives you the opportunity to direct questions to some of our best doctors who in their “free time” are full-time mothers too. Doctor Moms have raised children of their own and can provide a special perspective:	HealthTap的新医生妈妈给父母和准父母 一个直接向我们最好的医生提问的机会，这些医生在“空闲时间”也是是全职妈妈。医生妈妈亲自养育自己的孩子，她们可以提供一个特别的视角：
Ask a Doctor Mom!	询问一位Doctor Mom!
We’ve been looking for inspiring stories of people managing their health and well-being on HealthTap, and think that your story can be an inspiration to others (even if it’s anonymous).	我们一直在寻找关于人们在HealthTap上管理健康和幸福的振奋人心的故事，并相信您的故事可以激励他人（即使它是匿名的）。
from anonymous members like the one below:	来自匿名会员如下：
We believe that your story can be inspiring too and may even highlight it (anonymously) on our	我们相信您的故事可以是鼓舞人心的，甚至可能突出它（匿名）在我们的
With your permission, we may also share it with the media (without revealing your identity, unless you explicitly ask us to do so).	在您的许可下，我们还可能会与媒体分享（不透露您的身份，除非您明确要求我们这样做）。
. No story is too big or too short — they all bring smiles to our hearts and motivate our team, other users, and the amazing doctors who work day and night to help you and millions everywhere live healthier, happier lives.	.故事不会太长或太短之说 - 他们都能带来会心的微笑，激励我们的团队，其他用户和了不起的医生，这些医生昼夜不停地工作，帮助您和数百万的世界各地的用户，使大家的生活更健康，更幸福。
stories@healthtap.com	stories@healthtap.com
You can share your HealthTap experience by replying to this email or sending an email to 	您可以通过回复此电子邮件或发送电子邮件来分享您在HealthTap的体验 
Thanks for sharing,	感谢分享，
We’re so excited to have you join us on a journey to a healthier, happier life and feeling good every day.	我们很高兴能有您加入我们通向更健康美好的生活的旅程，很高兴能让您们每天都过得很好。
You now have instant access to millions of doctor answers, tips, news, app recommendations, and checklists	您现在可以即时访问数百万医生回复，小贴士，新闻，应用推荐和检查清单。
Ask health question 24/7 and get personalized, trustworthy answers from the comfort of your smartphone,	每天24小时询问健康问题，并轻松的从您的智能手机，
tablet or computer!	平板电脑或电脑获得个性化，值得信赖的答案！
Welcome to HealthTap — we’re excited to help you live a happier, healthier life!	欢迎来到HealthTap - 我们很高兴帮助您过上更快乐，更健康的生活！
To get personal doctor answers, medical advice, and treatment, please confirm your email	要获得个人医生的答案，医疗建议和治疗，请在出现提示时输入以下代码以
address by entering in the following code when prompted:	确认您的电子邮件地址：
During a consult you can discuss your most important health questions, receive expert medical advice, and have prescriptions and refills sent to your local pharmacy as needed – all from the comfort of your home.	在咨询期间，您可以讨论您最重要的健康问题，接受专家的医疗建议，并根据需要向您当地的药房发送处方和重新配方 - 所有这些都能在您舒适的家里获得。
Prefer to connect with your personal doctor on HealthTap?	希望在HealthTap上与您的个人医生取得联系吗？
Member Tips Digest	会员小贴士摘要
Today's TipTaps	今日的TipTaps
Please visit your Tips page to	请访问您的小贴士页面
Get started by choosing from these top doctors picked just for you:	从选择这些为您挑选的顶级医生开始：
You're awesome. Saying "Thanks" means a lot to our doctors.	您真棒。说“谢谢”对我们的医生意味着很多。
To thank you in return, we're offering you	谢谢您的回报，我们为您提供
15 days FREE of HealthTap Prime,	HealthTap Prime 15天免费
our premium service that gives you unlimited,	我们的高级服务，给您全天24小时，无限制的
24/7 access to doctors using your smartphone,	访问医生，通过您的智能手机，
tablet or computer.	平板电脑或电脑。
You're welcome :)	不客气 :)
At HealthTap we're continuously striving to improve your experience and that of the millions of people using HealthTap around the world. We'd love to hear from you about what you like about HealthTap, and what we can change and improve.	在HealthTap，我们不断努力改善您的使用体验，以及改善全球数百万使用HealthTap的用户体验。我们很愿意了解您喜欢HealthTap的地方，以及我们可以改变和改进的地方。
We're preparing for our bi-annual company retreat in Napa, California, where we'll plan the next generation of HealthTap.	我们正准备在加利福尼亚州的纳帕每年举行两次次公司撤退计划，我们将计划下一代HealthTap。
We'd appreciate your thoughts	我们非常感谢您对我们
on how we can make your HealthTap experience even better. Please take a moment to fill out	如何给您更好的HealthTap体验的想法。请花一点时间填写
this survey.	此调查。
Your feedback will both improve HealthTap for you, and positively impact people and doctors everywhere.	您的反馈将为您改善HealthTap，并对所有地方的人和医生产生积极影响。
When you complete the survey, we will enter you in a raffle to join us at our bi-annual company retreat in Napa, California with other members, doctors, and our core team!	当您完成调查时，我们邀您加入一次抽奖活动，与我们其他会员、医生和我们的核心团队一起参加我们公司在加利福尼亚的纳帕举行的一年两次的撤退计划。
Thank you for completing our extensive HealthTap survey -- your feedback is invaluable!	感谢您完成我们丰富的HealthTap调查 - 您的反馈是非常宝贵的！
We value your opinion tremendously and have created this short	我们非常重视您的意见，并创造了这个简短的
follow-up survey	随访调查
especially for people who filled out the first one. We're excited to help you and millions of others even better and would really appreciate a few more moments of your time.	特别是对于第一个填写的人。我们很高兴帮助您和其他数百万用户，真心感谢您愿意多花费几分钟时间。
You are our Hero! Thank you for completing our extensive HealthTap survey -- your feedback is invaluable.	您是我们的英雄！感谢您完成我们丰富的HealthTap调查 - 您的反馈是非常宝贵的！
As a member of HealthTap Heroes, we value your opinion tremendously and have created this short	作为HealthTap Heroes的会员，我们珍视您的意见，并创造了这个简短的
especially for people who filled out the first one. We're excited to help you and millions of others even better!	特别是对于第一个填写的人。我们很高兴能帮助您和甚至另外数百万用户！
With Prime you get 24/7 unlimited immediate access to top doctors by video or text chat to get: Advice, Prescriptions, Reminders	有了Prime黄金会员，您可以每天24小时的无限制立即访问顶级医生，通过视频或文字聊天获得：建议，处方，提醒
Great news! You've been gifted $30 off of Prime to live a healthier, happier life!	好消息！为了更健康，更快乐的生活，您已经赠送了30美元的Prime！
With HealthTap Prime, you'll have peace of mind with 24/7 unlimited, immediate access to top primary care doctors by video or text chat. You get personalized doctor advice, prescriptions sent to your local pharmacy, and reminders to keep your health on track!	成为HealthTap Prime黄金会员，您可以每天24小时通过视频或文字聊天，无限制立即访问普通门诊医生。您可以得到个性化的医生建议，处方会发送到您当地的药店，以及有人提醒您保持健康！
you get $30 off your HealthTap Prime subscription.	您获得了30美元的HealthTap Prime订阅。
You can feel good that you've given the gift of health to someone you care about.	您会因给了您所关心的人健康这一礼物而感到开心。
Invite more and get another $30 off!	邀请更多，并获得另一个30美元！
Choose how you would like to invite:	选择您要邀请的方式：
Or, tell your friends to use your promo code:	或者，告诉您的朋友使用您的优惠码：
We know you've been waiting a while for an answer to your question, and we'd like to thank you for your patience.  Unfortunately, we had to remove  your question from consideration at this time. Not all questions on HealthTap receive answers. A question is likely to go unanswered if it lacks sufficient detail, if the question is unclear to our doctors, or if it contains terms with which the doctors are not familiar.  Your question unfortunately fell into this category.	我们知道您已经为问题的解答等了一段时间，我们非常感谢您的耐心等待。很抱歉，我们必须在此时删除您的问题。在HealthTap上不是所有问题都能得到答案。如果问题不够详细，如果我们的医生不清楚问题内容，或者如果问题涉及到含医生不熟悉的术语，则问题可能不会得到答复。不幸的是，您的问题属于这个类别。
While we know it can sometimes be hard to frame your question, if you can edit your question to make it easier to understand and answer, you'll have a better chance of receiving a great answer from a top doctor.	如果问题不够详细，如果我们的医生不清楚问题内容，或者如果问题涉及到含医生不熟悉的术语，则问题可能不会得到答复。
Here are some suggestions for receiving helpful answers from our doctors:	这里有一些建议，是关于怎么能从我们的医生那里接收有用答案的。
We encourage you to look around HealthTap at other questions, tips, checklists, and relevant information and use them as references to improve your future questions. Having served more than a billion doctors' answers to people everywhere through our huge database of questions and health topics, we're confident that you'll find something similar that will either answer your question, or help you rephrase it in a way that our doctors can answer quickly	我们鼓励您在HealthTap上查看其他问题，建议，检查列表，和相关信息，并使用它们作为参考来改善您未来的问题。通过我们庞大的问题和健康话题数据库，我们为全世界的人们提供了超过10亿的医生答案，我们相信您会找到类似的东西来回答您的问题，或者帮助您改变它的方式，我们的医生都可以快速回答。
Browse answers to similar questions	浏览类似问题的答案
To make up for this inconvenience, we would like to offer you a 15-day FREE trial of HealthTap Prime; our premium service that gives you unlimited live consults with doctors 24/7 on any device. Get advice, prescriptions and personalized reminders from top doctors. Your questions also get priority status when asked through our anonymous “free” service.	为了弥补此不便，我们希望为您提供15天免费试用HealthTap Prime黄金会员的服务；我们的优质服务，将会给您，在任何设备上全天24小时的无限制实时医生咨询体验。您可以从顶级医生那里获得建议，处方和个性化的提醒。当通过我们的匿名“免费”服务提出问题时，您的问题也会获得优先级。
Thank you for putting your trust in us!	感谢您对我们的信任！
We've received your question. 	我们已收到您的问题。 
We'll email you as soon as a doctor responds	一旦医生回复，我们会向您发送电子邮件
If you prefer to speak with a doctor directly, send a message or schedule a virtual appointment	如果您喜欢直接与医生交流，发送信息或与您通过HealthTap Concierge
with a specialist of your choice through HealthTap Concierge and get:	选择的专家来安排虚拟预约并：
Who would you like to get help from?	您想从谁那里得到帮助？
Your case:	您的情况：
easily find answers and connect to doctors and specialists at your fingertips via video, voice or text	轻松找到答案，并且您只需通过您的指尖，以视频，语音或文字的方式，就能连接到医生和专家。
Through HealthTap HOPES, the world’s first Health Operating System, we’re streamlining and simplifying your entire healthcare experience. Whatever your health concerns, you can 	通过世界上的第一个健康操作系统，HealthTap HOPES，我们正在简化并且简化您的整个医疗体验。无论您有什么健康问题，您都可以 
Please click the link below to set your password and access your account.	请点击下面的链接来设置您的密码和访问您的账户。
The HealthTap team	HealthTap团队
We’re excited to help you manage your health and wellness! You now have immediate access to world-class healthcare at your fingertips.	我们很高兴能帮助您管理您的健康。通过您的手指，您就能立即访问到世界级的医疗保健。
We’re looking forward to helping you feel fantastic!	我们期待着帮助您感受到不可思议！
If you love HealthTap Prime, it's a sure bet your loved ones will, too!	如果您喜欢HealthTap Prime黄金会员，那么您的亲人也将会喜欢的。
get $30 off for every person who joins.	每加入一个人即可获得30美元。
To use these credits, please apply the following promo code when prompted for payment:	要使用这些积分，请您在系统提示付款时应用以下优惠码：
You can also share your promo code with friends and family in case they need to speak with a doctor, too.	如果您的朋友或家人需要与医生交流，您也可以把您的优惠码分享给他们。
Congratulations on taking the first step toward a healthier, happier you!	祝贺您，向更健康，更快乐的您迈出了第一步！
Once you do, we’ll immediately get to work finding just the right doctors to add to your Care-Team. That way whenever you need expert advice, you’ll have hand-picked doctors ready to answer your questions.	一旦您这样做了，我们将立即找到正确的医生，并添加到您的医疗团队。这样，每当您需要专家建议时，将会有精心挑选的医生来准备回答您的问题。
Your response is purely confidential and helps us create a better experience for all our members. Please let us know how we're doing!	您的回复是绝对保密的，这样将有助于我们为所有会员创造更好的体验。请告诉我们，我们正在做什么！
How likely are you to recommend HealthTap to a friend or relative?	您向朋友或亲戚推荐HealthTap的可能性有多大？
not likely	不太可能
very likely	非常有可能
Invite your friends and family, we'll give them $30 off HealthTap Prime—and you get $30 off your Prime subscription for every person that joins.	邀请您的朋友和家人，我们将给他们价值30美元的HealthTap Prime黄金会员， 并且对于每个加入的人，您将得到三十美元的Prime订阅。
With HealthTap Prime you get 24/7 unlimited immediate access to top doctors by video or text chat.  You get: Advice, Prescriptions, Reminders	使用HealthTap Prime黄金会员，您可以通过视频或文字聊天获得24/7无限制的即时访问顶级医生的权利。您获得：建议，处方，提醒
Welcome to HealthTap Prime! You’ve just taken an important step toward leading a happier, healthier life, with the help of HealthTap Prime. Now you can take advantage of all the wonderful things we offer! As a Premium member, you get:	欢迎来到HealthTap！在HealthTap Prime黄金会员的帮助下，您刚刚朝着更快乐，更健康的生活迈出了重要一步。现在您可以利用我们提供的所有美好的东西。作为一名高级会员，您可以：
You control the reminders you receive	您可以控制收到的提醒
In your	在您的
account settings	账户设置
you can control what information is sent to you, and where it’s sent.	您可以控制发送给您的信息以及发送到何处。
This ensures that these reminders are useful, and that you only get the information	这确保这些提醒很有用，并且您只能获取信息
you want sent to your email or mobile device.	您想要发送到您的邮箱或移动设备。
Change your	更改您的
settings	设置
or opt out at any time	或随时停用
You can unsubscribe from receiving reminders via email,	您可以通过电子邮件，
push notification, or both.  You can do this for any specific	推送通知或两者取消订阅接收提醒。您可以对清单上的任何特定
reminders or items on a checklist, or from email and push	提醒或项目，或通常的电子邮件和推送
notifications in general.  You control the utility, and	通知执行此操作。您控制的功用，和
the privacy, of the reminders you receive.	隐私，您收到的提醒。
Certain Prescriptions are Not Available through Virtual Consults	通过虚拟咨询得到的处方不全都是可靠的
Standard prescriptions issued by Primary Care Doctors for most common conditions are available via Virtual Consults.  Prescriptions not available through Virtual Consults include:	在虚拟咨询上，普通门诊医生为大多数病症发出的标准处方，是可靠的。不能通过虚拟咨询获得的处方包括：
Virtual Consults are Available in English	虚拟咨询可以用英语提供
Currently, Virtual Consults are available only in English.	当前，虚拟咨询只可以用英语提供
Happy ½ Birthday!  Remember this wise saying on your happy day: the more you celebrate your life, the more there is in life to celebrate!	生日 ½  快乐！记住这个“在您的快乐一天”的明智的说法，：您庆祝您的生活越多，那么您的生活中就越会有值得庆祝的事情！
Here’s to lots of celebration today! We wish you lots of good health for you and your loved ones in the coming year :)	今天这里有很多值得庆祝！我们祝愿您和您的亲人在接下来的一年能够健康:)
Happy ½ Birthday! Today is the perfect day to get a head start on your health before you turn another year older. Imagine blowing out your candles in six months and being even closer to your health goals.	生日 ½  快乐！今天是完美的一天，在下一年您长大一岁之前，开始您的健康之路。想象一下，在六个月内吹熄蜡烛，并且更接近您的健康目标。
You’re in luck! We’re giving you 15 days of HealthTap Prime — FREE! Talk to a doctor via live video or text chat 24/7 with any mobile device or personal computer. It's the easiest way to get the answers and advice you need to start becoming a healthier, happier you!	您很幸运！我们给你15天的HealthTap Prime - 免费！使用任何移动设备或个人计算机，全天24小时通过实时视频或文字聊天与医生交谈。这是获得答案和建议最简单的方法，您需要开始成为一个更健康，更快乐的您！
15 days of HealthTap Prime — 	HealthTap Prime 15天免费— 
We hope this makes your life happier AND healthier this year :)	我们希望能够让您今年的生活更加快乐和健康。
Here's to celebrating your special day!	在这里庆祝您特别的一天！
Here are all the awesome FREE things you get:	这里是您得到的所有极好的和免费的东西。
Doctor Answers	医生解答
Ask your health questions 24/7 and get trustworthy answers from top doctors	询问您的健康问题，并且从顶级医生那里得到可靠的答案。
Doctor curated content	医生策划内容
Access doctor answers, tips, recommended apps and articles based on your health interests.	基于您的健康利益，来访问医生的答案，小贴士，推荐的应用程序和文章。
Doctor checklists	医生清单
Achieve your health goals with doctor checklists and timely reminders	通过医生清单和及时提醒实现您的健康目标
Member Tip Digest	会员小贴士摘要
TipTap:	TipTap:
Share this tip!	分享这个小贴士！
How would you like to learn more about your health, get help when you need it, and take action to feel good?	您想如何了解更多关于您的健康问题，当您需要它怎样得到帮助，并采取行动感觉良好的方法？
I’m proud to be connected to the world’s most trusted source of doctor-created health information. Looking forward to you joining!	我很自豪能够连接到世界上最可靠的，由医生创建的健康信息资料库。期待您的加入！
With kind regards,	亲切的问候，
said in the update:	在更新中说道：
Please confirm your appointment or find another time that works better for you.	请确认您的预约或找到另一个更适合您的时间。
A message for you:	给您的一条消息：
How are you feeling?	您感觉怎么样？
Great work adding a condition to your profile! Now take the next step by connecting virtually with a doctor hand-picked just for you based on your interests:	您的个人资料中添加了一项优秀的工作！现在采取下一步，虚拟连接与根据您的兴趣为您选择的医生：
With HealthTap Concierge, you can easily schedule appointments, connect for live video or text consults, and send secure messages, day or night. It’s a great way to get a second opinion or ask questions without having to go into a physical office.	使用HealthTap Concierge，您可以轻松安排预约，连接现场视频或文本咨询，以及发送安全消息，且无论白天或黑夜。这是一个很好的来获得第二意见或询问问题的方式，并且不必进入实体办公室。
You can consult with these doctors to:	您可以咨询这些医生：
Note:	注意：
Replies to this email will not reach me. To ask me about a health concern, please accept this invitation and send me a message or schedule a virtual appointment with me on HealthTap. If you believe you may have an emergency, call 911 or immediately go to the ER.	我收不到此电子邮件的回复。如果要问我有关健康问题，请接受此邀请，并向我发送消息或在HealthTap上安排一个和我的虚拟预约。如果您认为您可能有紧急情况，请打911或立即去ER。
And many more reasons!	和更多的原因！
Try one of these top doctors instead:	请尝试这些顶级医生之一：
And remember, if you ever need to talk to a doctor immediately, you can use HealthTap Prime, which gives you 24/7 access to primary-care physicians via video or text chat from any phone or computer.	并且记住，如果您需要立即和医生交谈，您可以使用HealthTap Prime黄金会员，它可以通过视频或文本聊天的形式，从任何手机或计算机上，全天候地访问初级保健医生。
If this date doesn’t work, you may select a different time when confirming your appointment.	如果此日期无效，您可以在确认预约时选择其他时间。
Replies to this message via email will not reach the doctor. To ask questions about a health concern, please accept this invitation to send a message or schedule a virtual appointment with a doctor.	通过电子邮件回复此消息，将不会传达给医生。如果您要询问有关健康问题，请接受此邀请，来发送消息或安排与医生的虚拟预约。
Please sign into HealthTap using your desktop browser or mobile app 5 to 10 minutes before your scheduled appointment and ensure that your microphone and webcam are turned on and working. We’ll start your Virtual Appointment automatically at the right time. We want to let you know that if you are more than five minutes late, you will be charged for the appointment and the time slot will be given to another patient.	请在预定预约前5至10分钟，使用桌面浏览器或移动应用程序登录HealthTap，并确保您的麦克风和网络摄像头已打开并正常工作。我们将在正确的时间自动启动您的虚拟预约。我们想让您知道，如果您迟到超过五分钟，您仍将被收取约定费用，并且预约时间将被给予另一个患者。
Need to cancel or change your appointment? No worries! You can	需要取消或更改您的预约吗？别担心！您可以
any time. Just give us 24 hours notice out of professional courtesy to the doctor.	随时。只要给我们24小时通知的专业礼貌医生。
After that, unfortunately we won't be able to refund your fee.	之后，很抱歉，我们将无法退还您的费用。
To start your consult you can also use the button below 5 min before your appointment time.	如果要开始咨询，您还可以在约定时间之前5分钟使用按钮。
Please log onto HealthTap using your desktop browser or mobile app 5-10 minutes before your scheduled appointment, and ensure that your microphone and webcam are turned on and working. Please be prompt as we’ll start your Virtual Appointment automatically at your appointment time.	请在预约5-10分钟前，使用桌面浏览器或移动应用程序登录HealthTap，并确保您的麦克风和网络摄像头已打开并正常工作。请提示我们，以确保我们将在您的预约时间，自动启动您的虚拟预约。
Please be advised that if you’re more than five minutes late, you still will be charged for the appointment, and the time slot will be given to another patient.	请注意，如果您迟到超过五分钟，仍然需要被收取预约费用，并且预约时间将提供给另一个患者。
Is it time to start your appointment?	是时候开始您的预约吗？
any time.	随时。
Please note that appointments cancelled less than 24 hours from the appointment time will not be refunded.	请注意，从预约时间起，取消不到24小时的预约将不予退还费用。
43	43
OVERVIEW	概述
Earnings*	收益*
$90	$90
This week	本周
$1,235	$1,235
WEEKLY EARNINGS	每周收益
Week of: Aug 9-Aug 15, 2015	周：2015年8月9日-8月15
Total earnings: 	总收益： 
BALANCE	余额
Outstanding balance: 	未付余额： 
Total payments to date: 	当前付款总额： 
EARN MORE	赚的更多
Be creative! Our associates have found that a single effective social media post can drive multiple signups. Be sure include your unique referral link to receive credit for your signups:	有创意！我们的同事发现，一个有效的社交媒体帖子可以驱动多个注册。请务必添加您的唯一推荐链接，以便接受您的注册信用额度：
TIP	小贴士
Gaby got	Gaby获得了
12 Prime subscriptions in 10 days	10天内的12 Prime订阅
with a single facebook post, so we asked her to share her secrets.	与一个Facebook贴文，所以我们要求她分享她的秘密。
“Wonder how I'm getting all those subscriptions? Here are three pointers to help you. I don't have much sales experience, but I do love telling stories. Any good story has to answer three questions:	“想知道我如何得到所有这些订阅？这里有三个指示可以帮助您。我没有太多的销售经验，但我很喜欢讲故事。任何好的故事都必须回答三个问题：
1.  Who is this story for?	1.这个故事是谁？
2.  Why does this story matter?	2.为什么这个故事很重要？
3.  What do you want the reader to do or get out of it?	3.您想让读者做或者不做什么？
These three questions and their answers can help you get to where you want to do: making money by telling your audience about a service that will benefit them. HealthTap Prime is a paid subscription service for anytime, anywhere primary care Virtual Consults with doctors (HD video or chat, right from your computer or mobile device), advice, prescriptions, and reminders. You earn $25 for each sign up.”	这三个问题和他们的答案可以帮助到您想做的地方：通过告诉您的观众，一个将有利于他们的服务来赚钱。HealthTap Prime黄金会员是一种付费订阅服务，能随时随地提供普通门诊与医生的虚拟咨询（直接从您的计算机或移动设备进行高清视频或聊天），建议，处方和提醒。每次注册您的收入为25美元。
Stay tuned for more tips from Gaby in the coming weeks!	请关注Gaby在未来几周的更多小贴士！
Our mission is to help you  help your patients, and make the world a happier and healthier place.	我们的使命是帮助您，帮助您的患者，使世界成为一个更快乐和更健康的地方。
Feel free to reach out anytime to our team at	欢迎随时与我们的团队联系
(650) 376-6010	(650) 376-6010
concierge@healthtap.com	concierge@healthtap.com
In good health,	身体健康，
Congrats on completing your	恭喜您完成您的
Influencer earnings form!	Influencer收入表单！
Thank you for joining the	感谢您加入
HealthTap Ambassador Program!	HealthTap大使计划！
Here are the three services you can promote! Each of them provides access to top doctors who can give medical advice, prescribe medications, and order and review lab tests:	这里是您可以推动的三个服务！他们每个人都可以访问顶级医生，并且这些医生可以提供医疗建议，处方药物，以及订购和审查实验室测试：
Click to share your URL via email and social media! We’ll email you weekly reports on your earnings, and you’ll be paid seamlessly via PayPal each month*	点击通过电子邮件和社交媒体分享您的网址！我们会通过电子邮件向您发送有关收入的每周报告，并且您每个月将通过PayPal无偿支付*
Message or schedule a virtual appointment with doctors in over 137 specialties	与超过137种专业的医生通讯或安排虚拟预约
Your unique Concierge URL:	您唯一的Concierge网址：
Earn $5 for each Concierge consult purchased through your unique URL (retail price $39)	每个通过您的唯一网址（零售价格39美金）进行礼宾顾问购买的，您将赚取5美金
Reach more people by posting a widget on your website	通过在您的网站上发布小工具，吸引更多用户
Post this widget on your website or blog to help more people connect to doctors—an easy way to earn more money!	在您的网站或博客上发布此小部件，以帮助更多的人连接到医生，是一种赚更多钱的简单方式！
Simply copy the code below and paste it into your web page:	只需复制下面的代码，并将其粘贴到您的网页：
Prime Bundles	主要绑定
3 consults with primary care doctors to use anytime, anywhere	3次随时随地的门诊医生咨询
Your unique Prime bundles URL:	您唯一的Prime绑定网址：
Earn $5 for each Prime bundle purchased through your unique URL (retail price $49)	每个通过您的唯一网址（零售价格39美金）进行礼宾顾问购买的，您将赚取5美金
Prime Subscriptions	Prime订阅
Unlimited virtual consults with primary care doctors—anytime, anywhere	您可以随时随地，无限地与普通门诊医生进行虚拟咨询。
Your unique Prime subscription URL:	您唯一的Prime订阅网址：
Earn $25 for each Prime subscription purchased through your unique URL (retail price $99)	每个通过您的唯一网址（零售价格99美金）进行Prime订阅的，您将赚取25美金
We look forward to working with you! If you have any questions, please contact us at	我们很高兴与您一起工作！如果您有任何问题，请与我们联系
ambassador@healthtap.com	ambassador@healthtap.com
*Please see Agreement for additional information. PayPal may charge fees to receive payments; payments subject to anti-fraud protection holding period.	*获得其他信息，请查阅协议。PayPal可能收取付款费用；用于支付反欺诈保护期限。
Great news! A patient wants to get in touch with you using a HealthTap paid private message.	好消息！患者可能想要使用HealthTap付费私人消息与您联系。
HealthTap is the world’s leading Interactive Health Network that helps local patients find you based on your proven clinical expertise and the topics in medicine that you are known for in your community. Joining HealthTap as a doctor is free and takes less than a minute online or on your smartphone.	HealthTap是世界领先的互动健康网络，根据您熟知的临床专业知识可帮助当地患者，并且在您在社区中，通过您所熟知的医学主题找到您。作为医生加入HealthTap是免费的，并且只需不到一分钟的在线或在您的智能手机上。
Join HealthTap’s Medical Expert Network now to get your paid message and you will also:	立即加入HealthTap的医疗专家网络以获取您的付费消息，您还将：
Get your own free customizable mobile app (!) to better serve your patients	获取您自己可自定义的移动应用程序 (!)，能够更好地为您的患者服务
Enjoy personal rewards and a boost to your income	享受个人奖励，并提高您的收入
Enhance your reputation with a higher DocScore	通过更高的DocScore提高您的声誉
Gain recognition in the specialty topics that interest you	在您感兴趣的专业主题中获得认可
Attract new local patients and receive appointment requests online	吸引新的本地患者并在线接收预约请求
Share HIPAA-secure images and documents instantly with patients and colleagues anytime, anywhere	随时随地与患者和同事共享HIPAA安全图像和文档
You can also build your referral networks and connect with peers from Medical School, Residency, and beyond.	您还可以建立您的转诊网络，并与来自医学院，居留及其他地方的同学交流。
Give your patients access to the information they need from a source they can trust: you.	让您的病人可以从他们信任的来，获得他们需要的信息：您。
Sign up now to see your message. We look forward to welcoming you to HealthTap!	立即注册，查看您的信息。我们期待着您来HealthTap！
Sign up now.	现在注册。
All the best,	祝一切顺利，
PFA the attached file to delete experts	PFA附加文件删除专家
Low Consult Rating Feedback	低咨询评级反馈
ChatSession ID:	ChatSession ID:
Rating:	评分：
limited time, launch special pricing	限时特价
Try HealthTap Prime	尝试HealthTap Prime
today. You’ll have even more reasons to smile and feel good!	今天。您会获得更多微笑和感觉很好的理由！
Prime subscribers get:	Prime订阅者获得：
Back by popular demand–Buy 1, get 1 Free!	最受欢迎的需求——买1送1
Two doctor consults for the price of 1	这个医生咨询只要1个的价格
FINAL DAY	最后日期
Claim the offer now	立刻要求优惠
See how this offer helped one of our members:	了解此优惠如何帮助我们的会员：
Amy needed to get her cholesterol levels checked. With HealthTap’s new partnership with Quest Diagnostics, a doctor orders a lipid panel for her. Amy visits the nearest lab test center	Amy需要检查她的胆固醇水平。HealthTap与Quest Diagnostics的新合作伙伴关系，医生可以为她订购脂质面板。Amy访问最近的实验室测试中心
(2,200 available in the U.S.).	（在美国有2,200家可用）
When HealthTap receives her results, Amy sees Dr. Alder again online. He reviews the results and her medical history, then prescribes Statin, which she picks up at her local pharmacy that afternoon before her hiking trip.	当HealthTap收到她的结果时，Amy再次看到Alder医生在线。他检查结果和她的病史，然后给她开了他汀类药物，在她远足之前的下午，她可以在当地药店买到。
You too can get lab tests ordered and reviewed by U.S. doctors online!	您也可以得到美国医生在线订购和审查的实验室测试！
Limited-time offer–Buy 1, get 1 Free!	限时优惠——买1送1
2 days left	只剩2天
With advice and support from a caring doctor you can achieve all your health goals. See how this offer helped one of our members:	有了关怀医生的建议和支持，您可以实现所有的健康目标。了解此优惠如何帮助我们的会员：
Steve needed help managing his stress. After finding a useful tip by Dr. Anderson on HealthTap, he decides to see her online.	Steve需要帮助管理他的压力。Anderson医生在HealthTap上找到一个有用的小贴士后，他决定在线查看她。
Dr. Anderson reviews Steve’s medical history, they have a virtual consultation, and she creates a personalized checklist for him to follow.	Anderson医生回顾了Steve的病史，他们有一个虚拟的咨询，并且她创建一个个性化的清单来让他跟踪。
Thanks to Dr. Anderson’s specific action plan and HealthTap’s useful and timely push reminders, Steve feels more relaxed and learns to manage his stress.	幸亏有了Anderson医生的具体行动计划，和HealthTap有用且及时的推送提醒，Steve感到更轻松，学会管理他的压力。
What health goal do you want to achieve? Let HealthTap doctors help you too!	您想要实现什么健康目标？也让HealthTap的医生帮助您
Back by popular demand–BUY 1, GET 1 FREE!	最受欢迎的需求——买1送1
3 days left	只剩3天
Get the offer now	立刻获得优惠
Who ever thought you could see your doctor at the airport and pick up the prescription during your layover?	谁曾想过您可以在机场看到您的医生，并在您的停留期间拿起处方？
Jenny, mother of 3, was so relieved that Dr. Thompson could provide real-time advice about her son’s ear ache—he only had swimmer's ear and was prescribed Cortisporin Otic Solution (ear drops) that could be picked up during their 4 hour layover in LA.	3岁小孩的妈妈Jenny是这么放心的，Jenny医生可以提供关于她儿子的耳朵疼痛的实时建议 - 他只有游泳者的耳朵，被开出了皮质素耳溶液（耳滴） 的药方，并且在他们的4小时停留期间可以买到。
You too can benefit from having a doctor at your fingertips anywhere, anytime.	您也可以通过您的手指，在任何地方，任何时间从您的医生那里受益。
BUY 1, GET 1 FREE!	免费，买1送1！
4 days left	只剩4天
Claim this offer now	立刻要求此优惠
See how this offer helped one of our members Alex, and how it can also help and benefit you:	了解这项服务是如何帮助我们的会员Alex的，以及它如何帮助和惠及您：
Alex was on a camping trip and noticed a rash on his leg. He used HealthTap Concierge to get fast, expert advice from a doctor.	当Alex在野营旅行时，注意到他腿上的皮疹。他使用了HealthTap Concierge，以从医生那里获得快速，专业的建议。
In minutes, he was connected to Dr. Carson who informed him it was a poison oak reaction and advised to wash any exposed areas.	几分钟后，他与Carson医生取得联系，并得知这是一种毒性橡胶反应，建议清洗任何暴露的区域。
Based on his previous reactions, she prescribed a topical steroid, sent it to a pharmacy nearby, and was ready to pick up within a few hours.	根据他以前的反应，她开了一个局部类固醇，送到附近的药店，以备能在几个小时内取。
Three days later, Alex’s rash was almost completely healed thanks to the fast care from Dr. Carson.	幸亏有了Carson医生的快速护理，三天后，Alex的皮疹几乎完全愈合。
Don’t miss out on this amazing deal–buy one doctor consult, get another for FREE!	不要错过这个惊人的交易 - 买一个医生咨询，将得到另一个免费的名额！
I've found a great way for us to stay connected between visits.	我找到了一个保持我们之间联系的非常好的方法。
HealthTap is a free web and mobile service that allows you to ask health questions, receive daily health tips, and browse helpful information.	HealthTap是一个免费的网络和移动服务，允许您提出健康问题，接收每日健康小贴士，浏览有用的信息。
As your doctor, I have added you to my patient directory on HealthTap. By adding you to this list, your Health Profile will be visible to me. At any time, you can remove me as ‘Your doctor’ on my	作为您的医生，我已将您添加到HealthTap上，我的患者目录。通过将您添加到此列表，我可以看见您的健康档案。在任何时候，您都可以将我从您的「您的医生」页面移除。
page.	页。
I encourage you sign up for free and connect with me on HealthTap today.	我鼓励您免费注册，并今天在HealthTap上与我连接。
I'm excited to share with you a great free health app that I really like.	我很高兴与大家分享一个我真的很喜欢的，伟大的免费健康应用程序。
HealthTap provides you with answers tips and health information from tens of thousands of U.S. doctors – all for free! You can access it anytime, anywhere from your mobile phone or computer.	HealthTap为您提供来自数万名美国医生的答案小贴士和健康信息 - 并且全部免费！您可以随时随地从手机或计算机访问它。
Check it out today!	立刻查看！
You can now easily gain Free access to trusted health information 24/7 online and connect with me in a private, HIPAA-secure environment on HealthTap. I'm confident that you will really enjoy having healthcare at your fingertips!	您现在可以轻松获得全天24小时在线免费访问可靠健康信息的权限，并在HealthTap上的隐私的HIPAA安全环境中与我联系。我相信，您会享受到就在您指尖的医疗保健！
I'd love to give you the gift of health with a free HealthTap membership.	我很愿意给您健康的礼物，一个免费的HealthTap会员。
Dear colleague,	亲爱的同事，
Please join me today! To create your Free HealthTap account,	请立刻加入我们！免费创建您的HealthTap账号，
Link not working? You can also copy and paste this into your browser:	无效链接？您也可以将其复制并粘贴到浏览器中：
Or learn more about HealthTap	或了解有关HealthTap的更多信息
To see answers, other questions like this one and more,	看看像这一个和更多的答案，其他问题
Thank you for your interest in joining HealthTap's Medical Expert Network. Your verification has been held up due to one of many possible circumstances, most commonly a typographical error in your application (usually related to state license).	感谢您有兴趣加入HealthTap的医疗专家网络。您的验证因许多可能的情况之一而被搁置，最常见的是您的申请中的排字错误（通常与国家许可相关）。
 or call (650) 644-1833 to discuss the status of your application.	 或拨打(650) 644-1833来讨论您的应用程序的状态。
Please contact 	请联系 
We take the doctor verification process very seriously in order to protect the integrity and reputation of the individuals in the Medical Expert Network and our community of patients on HealthTap.	我们非常重视医生验证过程，以保护医疗专家网络中的个人，和我们的HealthTap患者社区的诚信和声誉。
We look forward to hearing from you soon.	我们期待着您的回复。
You're approved! Welcome to HealthTap and congratulations on joining the first doctor-trusted Interactive Health Network.	您已被批准！欢迎来到HealthTap，并祝贺您加入了第一个医生信任的互动健康网络。
We're so happy to have you here building your reputation, finding new patients and helping millions of people everywhere live healthier, happier lives.	我们非常高兴能在这里建立您的声誉，寻找新患者，并帮助世界各地的数百万人拥有更健康，更幸福的生活。
Use this email address to log in to your HealthTap account with the password you created.	使用此电子邮件地址，以您创建的密码登录到HealthTap帐户。
Here are some ways to get started on HealthTap:	在HealthTap有很多令人兴奋的机会。
To get started:	开始使用
There are a lot of exciting opportunities for you at HealthTap. Send me an email if you would like to learn more about becoming a Founding Expert, special leadership and community networking opportunities, getting featured on our popular blog, receiving HealthTap Office Decals, or other tips and tricks to ensure that you and your patients are getting the most out HealthTap.	在HealthTap有很多令人兴奋的机会。如果您想了解更多关于成为创始人、特殊领导和社区交流机会、获取我们的热门博客、接受HealthTap办公贴纸或其他小贴士和技巧以确保您和您的病人从HealthTap得到更多，请给我发送邮件。
You can reach me directly by sending a message to	您可以通过发送消息
or by calling (650) 644-1833.	或拨打电话(650) 644-1833直接与我联系。
Welcome aboard!	欢迎到来！
I'd like to personally invite you to be part of a special HealthTap video project. If you are passionate about health or have an inspiring story about how HealthTap impacted your life or the life of a loved one, this is your chance to share your enthusiasm with millions everywhere and be featured throughout major media outlets. (*If you prefer to remain anonymous, that works too – just let us know.)	我想亲自邀请您加入一个特别的HealthTap视频项目。如果您对健康充满激情，或有关于HealthTap如何影响您的生活或所爱的人的生活的启发性故事，这是您在各大媒体与数百万人分享您的热情的机会。（*如果您喜欢保持匿名也是可以的－至少告诉我们）
We’re looking for enthusiastic HealthTappers to join us this coming Tuesday (1/28) and Thursday (1/30) in Palo Alto, California for several limited filming slots.	我们正在寻找热情的HealthTappers来参加我们本周二（一月二十八号）和本周四（一月三十号）在加利福尼亚州的帕洛阿尔托几个有限的电影插槽。
If you aren’t able to join us in person on the 28th or 30th, you can still participate in this video project by sharing with us how HealthTap helped you or a loved one live a happier, healthier, better or longer life. You can share:	如果您二十八号或三十号无法亲自加入我们，您仍然可以参加视频项目与我们分享HealthTap是如何帮助您或所爱的人过上更快乐、更健康、更好或更长寿的生活的。您可以分享：
A quality video of you telling your HealthTap story.	一个您讲述您与HealthTap故事的优质视频。
An audio clip of you telling your HealthTap story.	一个您讲述您与HealthTap故事的音频剪辑。
Your HealthTap story, written in your own words.	用您自己的语言，书写关于您的HealthTap故事。
We’ll be featuring stories to inspire millions everywhere and would love to hear from you!	我们将介绍故事来激励数百万的人，并希望听到您的声音！
Member ID:	会员ID：
Member Profile:	会员资料：
Member Email:	会员邮箱：
Member Question text:	会员问题文本：
Loved One Email:	心爱的人的邮箱：
Member info:	会员信息：
Expert info:	专家信息：
Message info:	留言内容：
Link to the Upload:	上传链接：
Information this member provided:	这个会员提供的信息：
Member Full Name:	会员全名：
Member Location:	会员位置：
Request Connection Details:	请求连接详细信息：
Contact Us Form Details:	联系我们表格详情：
Media Gain Access Form Details:	媒体获取访问表格详细信息：
Invite Text:	邀请文本：
Colleague Email(S):	同事邮箱：
Patient Email(s):	患者邮箱：
Forgot Avvo email need help details:	忘记Avvo邮箱需要帮助详情：
No Submisstion Yet	还未提交
Happy Birthday! We send you our very best wishes for a happy and healthy day. Always remember this wise saying: The more you celebrate life, the more there is to celebrate!	生日快乐！为您快乐健康的一天送上我们最美好的祝福。永远记住这个至理名言：您庆祝生活越多，值得庆祝的就会越多！
And with that in mind...	记在心里...
15 days of HealthTap Prime—	HealthTap Prime 15天免费—
For your birthday, we're gifting you a 15-day free trial to HealthTap Prime. HealthTap Prime connects you to a top doctor through any mobile device or personal computer. Our doctors are available via video, voice, or text chat and can provide medical advice, refill your prescriptions, and even order lab tests for you—anytime, anywhere. We hope this makes your life happier AND healthier this year :)	我们为您的生日送上HealthTap Prime的15天免费试用。HealthTap通过任何移动设备或个人计算机让您联系到顶级医生我们的医生可以使用视频、语音或文字聊天并能够提供医疗建议，重新填写您的处方，甚至随时随地命令实验室给您测试。我们希望能够让您今年的生活更加快乐和健康。
Happy Birthday!	生日快乐！
It's your birthday, and we wanted to send you our very best wishes for a happy and healthy day.	这是您的生日，我们想为您快乐健康的一天送上我们最美好的祝福。
Remember this wise saying on your special day: The more you celebrate your life, the more there is in life to celebrate!	在您特别的日子里记住这个至理名言：您庆祝您的生活越多，生活中值得庆祝的就会越多！
Here's to you and your loved ones having a happy, healthy year :)	祝您和您爱的人享受快乐健康的一年。
Someone asked the doctors of	有人询问医生
a question:	一个问题：
Visit HealthTap to	访问HealthTap
this question or	这个问题或
refer	参考
it to a colleague.	一个同事。
Someone asked you a question on HealthTap:	有人在HealthTap上询问了您一个问题：
Just confirm your email address and we'll notify you when the question is answered by one of HealthTap’s US licensed doctors.	请确认您的邮箱地址，问题被任何一个HealthTap的美国持牌医生解答后我们会通知您。
Thanks, please notify me	谢谢，请通知我
Not interested in receiving an answer from a doctor? We can remove your email address.	不想接受医生的回答？我们可以删除您的邮箱地址。
Thanks, please don’t notify me	谢谢，请不要通知我
Thanks for asking a question on HealthTap!	感谢您在HealthTap上提问！
Yup, this is my email address	是的，这是我的邮箱地址
Not your question? We can remove if for you.	不是您的问题？我们可以为您删除。
Thanks, please delete this question	谢谢，请删除此问题
HealthTap provides health information and answers from thousands of doctors licensed in the United States. Anytime. Anywhere. 	HealthTap提供健康信息，并成千上万的从美国执照医生那获得答案。任何时间。任何地点。 
Create your personal Care-Team on HealthTap by adding primary care doctors, specialists, and HealthTap doctors licensed in your state to give you the guidance you need to feel happier and healthier. 	通过添加普通门诊医生、专家和在您所在州有执照的HealthTap医生在HealthTap上创建您的个人医疗团队，为您提供能使您感到更快乐和更健康的指导。 
When they accept, you can schedule virtual consults by appointment or send them  chat messages, each of which is about the cost of a regular office visit, yet from the convenience of your mobile phone or desktop computer!	当他们接受的时候，您可以通过预约安排虚拟咨询或给他们发送聊天信息，每个都是关于普通办公室访问的成本，对于您的手机或台式电脑是便利的。
Remember, the more doctors you invite, the more likely one of them will be available for you when needed :)	记住，您邀请越多的医生，他们越有可能在您需要的时候为您服务。
become a member	成为会员
learn more	了解更多
about becoming a doctor on HealthTap.	关于成为HealthTap的医生。
I'd like to personally invite you to	我想亲自邀请您
Here is a summary of activity on your profile on HealthTap:	这是在HealthTap上对个人资料的活动摘要。
Doctors who invited you to join:	邀请您加入的医生：
Doctors who voted for your expertise in one or more topic areas:	在一个或多个主题领域投票赞成您的专业知识的医生：
Patients who wrote recommendations for you:	为您推荐的患者：
Members who are now following you:	现在关注您的会员：
Members who voted for your expertise in one or more topic areas:	在一个或多个主题领域投票支持您的专业的知识会员：
where you can see what topics you are known for, read recommendations from your patients, consult with your colleagues, and gain recognition for your expertise.	在那里您可以看到您熟悉的主题、阅读患者的建议、咨询您的同事，并获得您的专业知识。
in 128 specialties from respected private practices and top institutions.  It's free and takes just a minute to	在受尊敬的私人实践和顶级机构的128个专业。它是免费的，只需1分钟
If you have any questions or comments, please contact us at expertsupport@healthtap.com, or call us at (650) 644-1833	如果您有任何问题和意见，请通过expertsupport@healthtap.com与我们联系，或致电 (650) 644-1833。
Get HealthTap on your mobile device - Free	在您的移动设备上获取HealthTap - 免费
Hi There!	您好！
We are happy to hear that you are going mobile! HealthTap has been designed to provide you health care information anytime, anywhere.	我们很高兴听到您正在前往移动端！HealthTap已经设计为随时随地为您提供医疗保健信息。
Download Free	免费下载
Let us know how was your experience at	告诉我们您的体验
HealthTap Feedback	HealthTap反馈
Hi i want to make	您好，我想
bold	冒昧地
Thank you for your recent question to our doctors on HealthTap. We found great answers to questions very similar to yours, and thought these answers might help you while you are waiting for your answer.	谢谢您最近在 HealthTap上对我们的医生的提问。我们找到跟您的问题相似很好的答案，并认为这些答案在您等待您的答案时会对您有所帮助。
Please let us know if you are satisfied with these answers by	如果您对这些答案感到满意，请告诉我们
clicking here	点击这里
to let us know you are satisfied with these answers.	告诉我们您对这些答案感到满意。
If these answers are not what you are looking for, there are two things you can do to get a faster answer to your question:	如果这些答案并不是您想要的，您可以做两件事来得到关于您问题的的更快的答案。
Rephrase your question to make it as clear as possible, and check for any inadvertent spelling errors (especially those errors that mobile devices sometimes introduce). Just	重新整理您的问题使其尽可能清晰，并检查是否有任何无意的拼写错误（尤其是移动设备有时引入的错误）。仅仅
You can also request priority handling when you submit a new question. Just	您还可以字啊提交新问题时请求优先处理。仅仅
For a charitable donation of $0.99, your question will be given priority over other questions to receive a faster answer.	对于$0.99的慈善捐款，您的问题将优先于其他问题获得更快的答案。
If you have any questions about this, feel free to send us an email to support@healthtap.com and we will be happy to help you.	如果您对此有任何疑问，随时给我们发送电子邮件至 support@healthtap.com，我们将很乐意帮助您。
Good health	身体健康
Geoffrey Rutledge MD PhD	Geoffrey Rutledge, MD, PhD
Quick guide to getting your questions answered on HealthTap	在HealthTap上解答问题的快速指南
Be Easy to Understand	容易理解
Questions must be in English, easy to understand, and about health or wellness topics. Common abbreviations are fine to use, but avoid unusual abbreviations.  HealthTap experts are U.S.-licensed doctors and seldom answer questions about uniquely foreign medications, or about hospitals and procedures in other countries.	问题必须是英文形式、容易理解，并且是关于健康主题的。通用的缩写可以使用，但要避免不常见的缩写。HealthTap的专家是美国授权的医生，很少回答有关独特的外国药物或关于其他国家的医院和程序的问题。
Ask Meaningful Questions	询问有意义的问题
Questions must include enough detail to be meaningful and answerable.  Vague questions that name a topic (for example, “I have a discharge”) without asking something specific are hard to answer. Try to mention whether the question is about a man or a woman, whether the topic relates to a certain age group, how long ago the symptoms started, and which parts of the body are affected.	问题必须包含足够的细节才是有意义和可回答的。提出一个主题（例如，“我有一个释放”）但没有询问具体问题的模糊问题很难回答。尝试提及无论问题是关于男人还是女人，无论该主题是否涉及某个年龄组，症状开始多久以及身体的哪些部分受到影响。
Check Spelling of Words and Medicines	检查单词和药物的拼写
Doctors may not understand a question if it contains many misspelled words. Lab test results should not be just numbers, but should include the units of measurement (such as pounds or mg/24hr).  If you mention a medication not available in the United States, be sure to include the generic name or the American brand name.	医生可能不能理解如果问题中包含太多的拼写错误。实验测试的结果不能仅仅是数字，而需要包含测量单位（如磅或mg/24hr）。如果您提及在美国不提供的药物，请务必包括通用名称或美国品牌名称。
Stay Private	保持私人
Do not include your name, names of other people, nor doctors’ names in the question.	在问题中不要包含您的姓名、其他人的姓名或医生的姓名。
If You’re a Minor, Get an Adult to Help	如果您是未成年人，请通过成年人获得帮助
The doctors avoid answering questions from minors under the age of 18, so parents should ask questions for the teens and children.	医生避免回答未成年人提出的问题，所以父母需要为子女提问题。
Regarding the question you asked:	关于您问的问题：
We're sorry to say that none of the doctors we have shown your question to has answered your question yet. If you haven’t already seen it, please review the quick guide to writing questions attached to this message, and then	我们十分抱歉，没有一个我们向其展示过您的问题的医生回答了您的问题。如果您还没有看到它，请查看快速指南以撰写此邮件附带的问题，然后
You can also request priority handling of new questions. Just	您也可以请求优先处理新问题。仅仅
Thanks again for your recent question on HealthTap. Quite a few doctors have seen your question, but so far no one has answered. I'd like to help you get an answer to your question by suggesting that you do one of the following:	再次感谢您最近在HealthTap上提出的问题。很多医生已经看过您的问题了，但到目前为止还没有一个人回答。我想通过建议您执行以下操作之一来帮助您得到问题的答案： 
In case you did not have a chance to look over the answers to questions similar to yours, here are some answers that may help you.	如果您没有机会查看类似您问题的答案，以下是一些可能会帮助您的答案。
Good news! Your question has been answered on HealthTap.	好消息！您的问题已在HealthTap上回答。
HealthTap provides health information and answers from thousands of doctors licensed in the United States. Anytime. Anywhere. For free.	HealthTap提供健康信息，并成千上万的从美国执照医生那获得答案。任何时间。任何地点。免费。
What's next?	下一步是什么？
to others and	和其他人
Pay it forward and	付款它并
of other doctors and patients awaiting an answer	其他医生和患者等待答复
and even sending a thank you note.	和甚至发送一封感谢信。
Share your answer	分享您的答案
with friends and family.	与朋友和家人
to HealthTap and give them the gift of personal, reliable health information from top doctors.	到 HealthTap并给他们来自顶级医生的个人的、可靠的健康信息的礼物。
just followed you on HealthTap.	只是在HealthTap上关注您。
Share HealthTap with your friends on Facebook and Twitter	在Facebook和Twitter上与您的朋友分享HealthTap
How does this work?	这个怎么用？
A patient has a question that requires more in-depth communication.	患者有需要更深入沟通的问题。
The patient reaches out to you and initiates a private, paid interaction with you. We call these “House Calls.”	患者会与您联系，并与您进行私人的付费互动。我们称之为“House Calls“。
You are sent the patient's initial message, requesting a paid reply.	您将收到患者的初始消息，请求付费回复。
Answer the patent's question. The patient will then be allowed to send you a short follow-up question, which you should also respond to.	解答患者的问题。然后患者将被允许给您发送一个简短的后续问题，您也应该回复。
Receive payment for your expertise and support!	接受您的专业知识和支持的报酬！
We know that health information is personal. That's why messages on HealthTap are secure. We take this stuff very, very seriously.	我们知道健康信息是属于个人的。这就是为什么HealthTap上的消息是安全的。我们非常非常重视这个东西。
Sometimes doctors get busy or have other issues come up that keep them from replying promptly. We know it can be frustrating, so we’d like to apologize for any inconvenience this may have caused. Here’s the message you sent:	有时医生很忙或者有其他的事情要处理，使他们无法及时回复。我们知道这是令人沮丧的，所以我们想为我们所造成的一切不便道歉。以下是您发送的邮件：
We’re glad you’re here. We’ll always do our best to get you the best health information available.	我们很高兴在这里见到您我们会尽力为您提供最好的健康信息。
You’re about to experience our refreshing new world for personal health. Here are a few things to help you get started and make the most of HealthTap:	您将要体验我们全新的个人健康新世界。以下是一些帮助您开始并充分利用 HealthTap的内容。
Build your online profile so our members can find and learn about you.	构建您的在线个人资料，以便我们的会员可以找到并了解您
Answer questions to demonstrate your knowledge and broaden your reach.	回答问题以展示您的知识，拓展触及范围。
Create Tips to engage our members and improve their health.	创建小贴士以吸引我们的会员并改善他们的健康。
Here’s your account information for your records:	以下是记录的您的帐户信息：
Medical Expert Weekly Digest	医学专家每周摘要
Follow us on:	关注我们：
YOUR DOCSCORE:	您的DOCSCORE:
This week at HealthTap	本周在HealthTap
THERE ARE NEW QUESTIONS FOR YOU TO ANSWER:	有什么您解答的新问题：
AGREE, COMMENT AND PROVIDE PEER-REVIEW:	同意，评论并提供同行评议：
answered "	已解答 "
":	":
SUGGESTED NETWORK CONNECTIONS	建议的网络连接
YOUR LEADERBOARD	您的领导
Your specialty:	您的专业：
YOUR RANK	您的排名
FEATURED NEWS	特色新闻
HEALTHTAP STAR OF THE WEEK	本周的HEALTHTAP之星
Get featured here:	获得精选：
FEATURED EXPERT OF THE WEEK	本周的特色专家
HEALTHTAP'S POLL OF THE WEEK	本周的HEALTHTAP的投票结果
 or by calling him at (650) 644-1833.	 或致电给他（650）644-1833。
 drrutledge@healthtap.com 	 DrRutledge@healthtap.com. 
If you ever find yourself needing help on HealthTap, you can reach Dr. Geoffrey Rutledge, our Medical Expert Network Director, directly by sending a message to 	如果您发现您需要HealthTap的帮助，您可以通过直接发送消息来联系我们的医疗专家网络主任Geoffrey Rutledge医生。 
Invite Patients	邀请患者
Invite Colleagues	邀请同事
Make your own app	制作自己的应用程序
Share HealthTap:	分享HealthTap：
You've got a reason to smile.	您有理由微笑。
Learn More.	了解更多。
Manage your email settings here.	此处管理您的邮箱设置。
We're giving away an Apple Watch to the first Concierge doctor to complete 100 Virtual Consults in HealthTap Concierge.	我们正在向第一位专家医生赠送 Apple Watch以完成 HealthTap专家的100个虚拟咨询。
The easiest and fastest way to start seeing more patients for consults is to use all of the	开始看更多患者咨询最简单快捷的方法是使用所有
tools and resources on the	工具和资源
Promote your Practice	促进您的实践
page. You can send email invitations to your patients, get access to customized handouts for your	页。您可以给您的患者发送邮件邀请，
patients and much more.	获取您的患者的定制讲义以及更多信息。
Related exciting news:	相关激动人心的消息：
as of today,	截至今日，
HealthTap is launching the first Apple Watch app	HealthTap推出了第一个Apple Watch应用程序
that provides people with instant access to HealthTap Prime doctors.	为人们提供对 HealthTap专家医生的即时访问。
You're a part of an exciting and truly revolutionary moment in healthcare	您是医疗保健领域一个令人兴奋和真正革命时刻的一部分
access and provision.	访问和提供。
We're honored to partner with you in this journey.	我们很荣幸能在这次旅程中与您合作。
Good luck! We're here to support you if you have any questions.	祝您好运！如果您有任何问题，我们将在此支持您。
Feel free to reach out to our team of experts at	欢迎随时与我们的专家团队联系
You may download your certificates at any time here:	您可以随时下载您的证书：
Please let friends and colleagues know about this course so they, too, can join the Virtual Care Movement!	请让朋友和同事了解次项目，让他们也能加入虚拟护理运动！
All you need is a smartphone, tablet, or computer—the ultimate convenience, saving you both time and money.	您所需要的是一个智能手机、平板电脑或计算机－为您节省时间和金钱的便利。
simplifying your entire healthcare delivery and management experience	简化您的整个医疗保健交付和管理经验。
Through HealthTap HOPES, the world’s first Health Operating System, we’re streamlining and 	通过 HealthTap HOPES,世界上第一个健康操作系统，我们正在精简和 
HealthTap is the world's first Health Operating System, allowing you to	HealthTap是世界上第一个健康操作系统，允许您
We believe access to healthcare is a fundamental human right and are excited to welcome you to HealthTap!	我们相信获得医疗保健是一项基本的人权，我们很高兴欢迎您来到HealthTap！
If you would like to add a personal note, change the content of the newsletter, or disable the newsletter, you can visit the link below.	如果您想添加个人笔记、更改简报内容或禁用简报，您可以访问一下链接。
Have a wonderful day,	美好的一天，
Expert Newsletter	专家简报
Please share your feedback about my practice:	请分享您对我的实践的反馈：
Provide Feedback	提供反馈
An account has been created for you to help greet patients and connect them to their provider when ready. Please	已为您创建好一个帐户来迎接患者并使他们与供应相连接一旦准备就绪。请
Thank you for helping patients on HealthTap!	谢谢您在HealthTap上帮助患者！
Total earnings:	总收益：
Please sign up for	请注册
Payoneer	Payoneer
by the end of this month so we can disburse your earnings to you next month.	到了月末，所以我们可以在下个月支付您的收入。
Total charges:	总费用：
Our mission is to help you help your patients live healthier, happier lives.	我们的使命是协助您帮助您的病人过上更健康、更快乐的生活。
Feel free to reach our team at	欢迎随时联系我们的团队
650-376-6010	650-376-6010
 or	 或
prime@healthtap.com	prime@healthtap.com
First name:	名：
Last name:	姓：
ID user:	用户ID：
Claim details:	索赔细节：
Claimed id:	索赔ID：
Claiming Date:	索赔日期：
charity name:	慈善名称：
Address line 1:	地址栏1：
Address line 2:	地址栏2：
City:	市：
State:	州：
Zip:	邮递区号：
Order of:	名称序列：
Phone:	手机：
Degree:	学历：
Medical school:	医学院：
Primary training:	初级培训：
Area of practice:	实践领域：
Board certified:	董事会认证：
Board names:	董事会名称：
Medical license:	医疗执照：
License State:	执照状态：
Dob:	Dob:
In practice:	实践中：
Campaign	活动
Thank you for using HealthTap. This email confirms that you’ve de-activated your account with us.  We’re sorry to see you go and hope you’ve enjoyed being a part of our community.	感谢您使用HealthTap。此电子邮件确认您已经停用了我们的帐户。我们很抱歉看到您离开，希望您享受作为我们社区的一部分。
For now, we’ve temporarily disabled your account. If you’d like to sign up again, just get in touch with us and we’ll help you re-activate your account.	目前，我们已暂时停用您的帐户。如果您想再次注册，请与我们联系，我们会帮助您重新启用帐户。
If you wish to permanently deactivate your account and all information associated with it, please send us an email.	如果您希望永久停用帐户及其相关的所有信息，请给我们发送电子邮件。
All the best, in health and otherwise,	一切都好，健康和其他方面，
Now that you’ve deleted your account, HelathTap will no longer send you emails.	既然您已经删除了您的帐户， HealthTap不会再给您发送邮件。
We’ve issued you a full refund so you can ask another doctor.	我们已向您发出全额退款，因此您可以要求另一名医生。
Total	总共
Following Experts are ready to be reviewed on Editorial Board:	以下专家准备在编辑委员会进行审查：
Thanks for helping us help millions make better choices and live healthier happier lives.	感谢您帮助我们帮助数百万人做出更好的选择并过上更健康快乐的生活。
Sincerely	真诚地
Dr. Geoffrey Rutledge and the HealthTap Team	Geoffrey Rutledge医生和HealthTap团队
sent you a secure health file.	向您发送了一份安全健康文件。
Shift is double booked	轮班是双重预订的
day of week:	星期几：
shift number:	轮班编号：
state:	状态：
New shift holder:	新轮班持有人：
Original shift holder:	原轮班持有人：
–	–
Gratefully,	感激地，
This will allow your staff to get access to your practice portal to help you grow and manage your Virtual Practice.	这将允许您的员工访问您的练习门户以帮助您的成长和管理您的虚拟实践。
Link to office staff portal:	连接到办公室工作人员入口：
If you have any questions or would like to update your office staff information,	如果您有任何疑问或想更新您的办公人员信息，
Best Wishes,	最美好的祝福，
The HealthTap	HealthTap
Also, I recommend you take a look at our	此外，我建议您看看我们的
brief video tutorial	简短视频教程
(2:04) on inbox consults, and let us know anytime if you have questions or concerns.	（2:04）在收件箱咨询并告诉我们，在任何时候只要您的问题或疑虑。
If the patient has a poor experience because of this connection issue, we may not be able to pay you for the consult.	如果由于这个连接问题患者的体验不佳，我们可能无法支付您的咨询费用。
You have	您有
who would like to add you to their Care Team.	想把您添加到他们的医疗团队。
With	和
, you have ultimate flexibility to set up your Virtual Practice and schedule your own Virtual Office Hours whenever most convenient for you.  Practice at your convenience – for as many hours as you like, at anytime, day or night, weekday or weekend, and from anywhere. Deliver efficient, concierge-style care via Virtual Appointments that will delight patients in your practice. You can also grow your practice by accepting new patients who find you on HealthTap.	，您可以极其灵活地设置虚拟练习并为您安排自己的虚拟办公时间。在您方便的时候练习－任何时间，白天或晚上、工作日或周末，以及任何地方。通过虚拟预约提供高效、专家式的护理，这将使您的实践中的患者感到高兴。您也可以通过接受在HealthTap上找到您的新患者来促进您的实践。
With HealthTap Concierge you can	使用HealthTap Concierge您可以
As noted by your colleagues:	正如您的同事所述：
"This is an incredible opportunity to bring the patient and doctor back together, without all the bureaucratic middlemen." (Dr. David Wiebe)	“这是一个难以置信的机会，让患者和医生重新一起，没有任何官僚中间商。”(David Sneid医生)
(650)376-6010	(650)376-6010
DrRutledge@healthtap.com	DrRutledge@healthtap.com.
Get paid well, and quickly	支付得很好，很快
Practice from anywhere, anytime	随时随地的实践
Practice efficiently and affordably!	高效实惠的实践
Your colleague, Dr. Andrew Silverman, Fertility Medicine (New York, NY), loves HealthTap Concierge. He says,	您的同事， Andrew Silverman医生，生育医学（纽约州），喜欢 HealthTap Concierge。他说，
"I can help more people through the web site than I ever could through the office... plus, it's fun to be able to share your expertise without having the headaches with billing and copay."	“比起通过办公室，我可以通过网站帮助更多的人…另外，能够分享您的专业知识而不会产生头痛的账单和共付费用是很有趣的。”
(650) 376-6025	(650) 376-6025
Jen	Jen
Isaac and The HealthTap Team	Isaac和HealthTap团队
Congratulations,	恭喜，
You have just grown your Virtual Practice by connecting with 1 patient!	您刚刚通过连接一个病人成长了您的虚拟实践！
Your new virtual patients:	您新的线上患者：
patient ›	患者 ›
Remember:	记住：
Accepting patients, performing virtual consults, and administering prescriptions is at your discretion. Always exercise professional judgement and abide by all applicable regulations governing virtual consults in your state.	接受患者、执行虚拟咨询和管理处方是由您自行决定的。始终行使专业判断并遵守所有适用于规则的虚拟咨询法规。
You can update your	您可以更新您的
automatic acceptance ›	自动接受&gt;
and remove	和删除
connected patients ›.	连接的患者&gt;。
Congratulations on being part of the movement that is revolutionizing healthcare! We hope you are as excited as we are to get started with your Virtual Practice in HealthTap Concierge.	恭喜成为医疗保健领域改革运动的一部分！我们希望您受HealthTap邀请开始您的虚拟实践时和我们一样兴奋。
Don’t forget to complete the required training session for a brief overview of the interface and start getting paid for virtual consults. The link will remain live for another 2 days. So get started now.	不要忘了完成所需的关于界面简要概述的培训会议并开始为虚拟咨询获得报酬。该链接将继续保持活动2天。所以立刻开始：
Please send any questions, comments or suggestions to	请发送任何问题，意见或建议到
concierge@healthtap.com,	concierge@healthtap.com
or call us at	或致电
) 	) 
Welcome to HealthTap Concierge! Activate your new Virtual Practice now and get paid to see patients virtually.	欢迎来到HealthTap Concierge！现在激活您新的虚拟实践并通过在线为患者看病获得报酬。
The tutorial will walk you through the platform so that you'll feel comfortable and confident knowing how to use it when you	本教程将引导您通过平台，让您舒服与自信的与患者
consult with patients.	进行咨询。
After the tutorial, use these tools to grow our Virtual Practice:	在前导教程之后，用这些工具来发展我们的虚拟实践：
You're only a few minutes away from getting paid to help your patients with virtual care.	再过几分钟您就可以通过在线帮助患者来获得报酬了。
Take advantage of this amazing opportunity by completing this short tutorial to ensure you're	抓住这次神奇的机会，通过完成这简短的前导教程以确保您
familiar with how our platform works,	熟悉我们平台如何运行
and to feel comfortable and confident when patients need your expertise using HealthTap.	在病人使用HealthTap需要您的专业技能时感到得心应手。
On HealthTap you can:	在HealthTap您可以：
And much more!	和多得多！
Build your network of	建立您的
followers.	关注者网络。
View your	查看您的
today to check your stats and learn even more ways to improve your DocScore today!	今天检查您的统计并学习更多方法来增加您的医术。
Congratulations! You’ve been “Hearted” by a patient during	恭喜！您已经被一位患者 “Hearted”在
HealthTap’s	HealthTap的
2012 “I Heart My Doc” initiative for your dedication and care everyday. In honor of this, we’ve featured you on the	2012“I Heart My Doc”期间，为您每天的奉献和关心。为了纪念这一点，我们为您推荐了
Wall of Hearted Doctors	心灵医生之墙
, where we are showcasing the 100 most recently “Hearted” doctors.	是我们展现100位近来最有心医生的地方。
When you join	当您加入时
, we’ll add the new “I Heart My Doc” badge to your Virtual Practice so that patients everywhere can see how you’ve touched people’s lives in very meaningful ways.	，我们在您的虚拟实践中添加了新的“I Heart My Doc”奖章以使所有人都能看到您是怎样用各种有意义的方式接触人们的生活。
HealthTap is changing the way people find trustworthy, personalized health information online and interact with medical experts like you. As a HealthTap Medical Expert you will: - Build your reputation and gain recognition among patients and colleagues - Attract new patients - Serve your existing patients better - Save time and money	HealthTap改变了人们在线寻找值得信任的个性化医疗信息和与像您一样的医疗专家互动的方式。作为HealthTap医疗专家，您将：在患者和同事间建立您的声望并获得他们的认可，吸引新的病人，更好地服务您现有的病人，节省时间和金钱。
As people across the country and the national media continue to rave about HealthTap, our user numbers continue to soar, and the "I Heart My Doc" campaign is one more way that HealthTap can boost your visibility and reputation, drawing even more attention to you and directing even more traffic to your free HealthTap Virtual Practice.	当全国的人民和国家媒体持续热烈讨论HealthTap时，我们的用户数量持续激增，“I Heart My Doc”活动是另一个HealthTap可以增加您的曝光率和声望并吸引更多可增进您免费虚拟实践的资源的方式。
sign up online	线上注册
or to download our	或下载我们的
#1 featured HealthTap Mobile Express MD app	#1 featured HealthTap Mobile Express Md应用程序
for iPhone, iPad, or Android. I'd be delighted to answer any questions you have at	适用于iPhone，iPad或Android。我很高兴回答您的任何问题
or please call me at the number below.	或通过下面电话致电我。
I look forward to getting you featured on HealthTap today!	我期待您今天在HealthTap的精选！
Geoffrey	Geoffrey
Geoffrey Rutledge, MD	Geoffrey Rutledge, MD
Director, Medical Expert Network	医学专家网络主任
Direct Line: (650) 644-1833	直达专线：(650) 644-1833
View my HealthTap Virtual Practice	查看我的HealthTap虚拟实践
Download the #1 Featured HealthTap Express MD mobile app	下载#1 Featured HealthTap Express MD 移动应用程序
a HealthTap member, would like you to answer	一位HealthTap会员，希望您回答
question:	问题：
Updated in last 24 hours	在过去24小时内更新
Members have asked the following questions today on topics of interest that you follow. Share your expertise and help these individuals by answering any of the questions below:	会员们今天询问了下列关于您感兴趣的议题的问题。通过解答下列问题来分享您的专业技能并帮助这些个人。
Want to modify which topics you are subscribed to?	想要修改您订阅的主题吗？
Every day, HealthTap users ask more questions - creating more opportunities for you to share your expertise and help people everywhere.	每天，HealthTap用户提出了越多问题就为您创造了越多分享您的专业技能和帮助各地人们的机会。
Click on any of the 5 questions below to answer, or go to	点击以下5个问题中的任何一个来回答，或
to see more.	查看更多。
See more questions on	查看更多问题在
HealthTap.	HealthTap。
- The HealthTap Team	- HealthTap团队
Message:	信息：
Congratulations, you’ve been approved as a HealthTap Prime doctor. Welcome to the team!	恭喜，您被认证为一名HealthTap Prime黄金医生。欢迎来到团队！
Your start date has been deferred because we don’t have available shifts at the times you selected, or in the state(s) you practice in. We have simply experienced so much success that we are at capacity right now. However, we are thrilled that you are on board, and as soon as the opportunity arises, we will offer you shifts. Millions of patients around the world are seeking doctors with your expertise!	您的开始日期已被推迟，因为我们在您选择的时间或状态没有可行的替换，我们已经经历了如此的成功以至于达到最大负荷。然而，我们对您的参与很高兴，一旦有机会我们就会向您提高替换。世界各地数以百万计的患者正在寻找拥有您的专业技能的医生！
Indeed, if you like, you can start seeing patient's right away by making yourself "Available" on an ad-hoc basis to accept consults from any patients waiting in the queue when our shift doctors are busy seeing other patients.	事实上，您可以通过基于ad-hoc 的方式来接受我们的医生忙于为其他患者服务而正在排队等待的患者的咨询，如果您喜欢，这样能使您立刻见到患者。
And of course, you can always answer members’ questions, curate articles and research, create tips and checklists--and do all the other things that will raise your DocScore™ and make people smile and feel good.	当然，您能一直回答会员的问题、撰写文章和研究报告、创建贴士和清单，做这样的事情会增加您的医者分数，也会使人们展颜欢笑。
We’ll contact you when the situation changes. In the meantime, we recommend checking that your profile is up to date, and that it contains all your qualifications, accolades, and practice information, so that you achieve the highest DocScore™ possible. Virtual Consultants with higher DocScores™ take precedence when it comes to scheduling.  Staying active in the Medical Expert Network and providing helpful answers to members’ questions that other doctors agree with will also help your DocScore.	当情况发生变化时，我们会联系您。同时，我们推荐您查看您的简介包括所有的资格证书、荣誉和实践信息是否是最新的以便您有机会取得最高的医者分数。有更高医者分数的虚拟医生会在安排时获得优先权。在医疗专家网站上保持活跃和向会员提供其他医生认可的对问题有益的答案也会帮助您提高您的医者分数。
We look forward to working with you!	我们很高兴与您一起工作！
Update your profile »	更新您的资料 »
If you have any questions in the meantime, please contact us at	如果您在此期间有任何问题，请与我们联系
HealthTap Prime: Do good. Do well. Feel good.	HealthTap Prime：做好。做好。Feel good.
Warm regards,	温暖的问候，
Congratulations on launching your Virtual Practice on HealthTap Concierge!	恭喜您受HealthTap邀请开始您的虚拟实践。
Based on popular demand, we have now made it very easy to invite your current patients to join your ViP!	基于流行的需求，我们现在降低了邀请您当前的患者加入您的vip的门槛。
Here are some of the benefits of inviting your patients:	以下是邀请您的患者的一些优势：
Increase your bottom line revenue	提高您的最低收入
Give ongoing care in-between office visits	在办公室访问之间持续提供护理
Have access to patient charts for all consults	为了咨询可以访问患者图表
Be on the forefront of digital interactive health technology	走在数字互动健康技术的前沿
Doctors who invite their patients have a 21% increase in consults	邀请患者的医生的咨询增加了21％
Increase the number of patients you see in your real-world office	增加您在现实中办公室看到的患者数量
Delight your patients by providing care via video or text	为您的患者通过视频或文字提供治疗
More consults drives higher ratings, increases your DocScore, drives greater visibility to your ViP, and therefore more consults!	更多的咨询带来更高的等级，增加您的医者分数，带来对您的vip更多的可见度，因而也带来更多的咨询！
My patients love that they can connect with me from anywhere. I love offering them this added flexibility in a secure, private, easy-to-use platform where everything is well documented, and I can get paid for my time.	我的患者喜欢在任何地方都可以和我联系。我喜欢在这样一个一切都被妥善归档的安全、隐私、便于使用的平台上提供灵活的服务并为我的时间取得报酬。
- Dr. Pamela Svendsen, Family Medicine (Navarre, FL)	- Pamela Svendsen医生, 家庭医学 (Navarre, FL)
Drive more patients to your practice with HealthTap Concierge!	使用HealthTap Concierge推动更多的患者参与您的实践！
Get FREE access to HealthTap Concierge to help bring patients into your practice	免费进入HealthTap，把患者带入您的实践。
Ultimate flexibility	极强的灵活性
Set your hours	设置您的时间
Practice from anywhere on any mobile device or computer	在任何移动设备或计算机上随时随地的实践
Get paid quickly	很快的得到报酬
No overhead or billing hassles	没有间接费用或计费麻烦
Delight your patients	祝您的患者
Provide care via live video or text consults	通过实时视频或文字咨询提供护理
Give ongoing care to patients between office visits	在访问办公室时持续提供护理
Millions of people on HealthTap look for doctors to connect virtually and in-person.	数以百万计的人在HealthTap上寻找虚拟和私人的医生。
Generate revenue directly from consults, as well as by bringing new patients who find you on HleathTap into your real-world office.	在咨询中直接获益的同时把从HealthTap上看到您的新患者带到您的现实办公室。
Striving for efficiency? Earn more in less time with HealthTap Concierge!	追求效率？使用HealthTap Concierge能够在更短的时间内赚取更多！
 Enjoy the flexibility of giving consults from anywhere, at any time, using any device, and without any overhead or other costs.	 享受这种不论何时何地使用何种设备并且没有任何费用都能给出咨询的灵活性。
Get FREE access to HealthTap Concierge and use virtual care to see patients quickly and efficiently. Start earning more in less time by seeing patients via live HD video or text Virtual Consults. 	免费登录HealthTap并用虚拟关怀来快速有效地诊断患者。通过生动的视频或文本虚拟诊段患者来在更少的时间里挣更多的钱。 
Take advantage of this highly efficient and cost-effective way to enhance the services you offer, delight your patients, and boost your income.	利用这个高效低价的方法去改进您的服务，取悦您的患者，增长您的收入。
We selected you for an exclusive invitation to join HealthTap Concierge.	我们用一个专用的邀请选择您加入HealthTap。
from a mobile device or computer.	从移动设备或电脑。
Many [SPECIALISTS]s are already using the service to:	许多[SPECIALISTS]已经在使用该服务：
Manage patients in nursing homes via remote consultation	通过远程咨询在疗养院管理患者
Give in-home medication management consultations for homebound patients	为不宜外出的患者提供在家医疗管理咨询
Evaluate new medication side effects in real-time with a virtual consult	通过现实时间的虚拟咨询来评估新药的副作用。
Help patients suffering from dperession by giving frequent and convenient consultations	通过频繁和方便的咨询帮助遭受抑郁症折磨的患者
Provide preventative care consultations for at-risk patients	为危险的患者提供预防性医疗咨询
Our mission is to help doctors and patients benefit from the latest technology and help you reach your practice's goals. We want to help you help your patients, and together we will make the world a healthier, happier place.	我们的任务是帮助医生和患者享受最新科技带来的优势并帮助您达到实践的目标。我们想帮助您帮助您的患者，我们一起缔造一个更健康快乐的地方。
If you have any questions, please schedule a call	如果您有任何问题，请安排一次电话
You can also reach out to our team at	您也可以联系我们的团队
We hope to work with you soon!	我们希望尽快与您合作！
to join our fastest growing virtual care service, HealthTap Concierge.	加入我们增长最快的虚拟护理服务，HealthTap Concierge。
Practice at your convenience, anytime, anywhere	在您方便的时候随时随地的实践
Provide video, voice or text consults from any mobile device or computer	向任何移动设备或电脑提供视频、声音或文本咨询
Get paid well and earn money without overhead or billing hassles	获得很好的报酬并在没有管理费用或其他账单争论的情况下挣钱
See patients who are looking for a [SPECIALIST] in [STATE]	查看正在正式寻找专业医生的患者
Our mission is to help doctors and patients benefit from the latest technology. Our consultants out of our Silicon Valley headquarters	我们的任务是帮助医生和患者从最新科技中获益。我们来自硅谷总部的咨询师
will work with you individually to help you reach your goals. We want to help you help your patients, and together we will make the world a healthier,	会和您一起工作以帮助您达成目标我们想帮助您帮助您的患者，我们一起缔造一个更健康，
happier place.	更快乐的地方。
Dr. Moshe Lewis, Physical and Rehab Medicine	Moshe Lewis医生，物理和康复医学
Dr. Jodi Ritsch, Family Medicine	Jodi Ritsch医生，家庭医学
Set your hours and boost your income by giving live video, voice, or text consults to patients from anywhere, at anytime, using any mobile device or personal computer.	设置您的时间，随时通过用移动设备或个人电脑给来自各地的患者提供视频、语音或文本咨询以获益。
When you sign up for HealthTap Concierge, our team will work with you individually to help you reach your goals, whether you want to:	当您注册了HealthTap后，我们的团队会和您一起工作来帮助您达到您的目标，您是否想要：
Have ultimate flexibility	有极强的灵活性
Our goal is to help you help your patients, and together we will make the world a healthier, happier place.	我们的目标是帮助您帮助您的患者，我们一起缔造一个更健康快乐的地方。
The future is here! Take a minute to sign up for free:	未来在这里！花一分钟免费注册：
your doctor	您的医生
As a member of HealthTap Prime, you get to use HealthTap Concierge without paying any extra fees! This allows you to see 	作为一个HealthTap的黄金会员，您使用HealthTap将不需要任何其他费用！这让您看到 
If your doctor isn’t yet on HealthTap, invite him or her to join today!	如果您的医生尚未加入HealthTap，今天邀请他/她加入！
Use HealthTap Prime and HealthTap Concierge together to stay healthy and feel good all the time.	同时使用HealthTap Prime和 HealthTap Concierge来一直保持健康。
 service.	 服务。
With HealthTap Concierge you can:	使用HealthTap Concierge您可以
Request an immediate Virtual Consult, schedule virtual appointments, and send messages anytime, from anywhere to your doctor for an affordable per-visit fee	无论何时何地只要付出一笔可承受的访问费都可以向您的医生要求即刻的虚拟诊断，虚拟预约或发消息。
Get prescription refills, personalized reminders, and tips from your own doctor for activities that help you meet your health goals	从您的医生那里获得您的处方，设置个人提醒以及小贴士能帮助您达到您的健康目标。
In addition to connecting with your own doctor, you can also get a second, third, or tenth opinion from doctors in more than 105 specialties without waiting weeks.	除了可以联系您自己的医生，您也可以不用排队地从超过105位专业医生中随意挑选。
 doctors without dealing with traffic and waiting rooms, then HealthTap Concierge is for you!	 HealthTap Concierge提供给您没有等待室的医生！
If you’ve ever wanted to connect with 	如果您曾经想要连接 
Request an immediate virtual consult or schedule appointments using your mobile device or personal computer	使用您的移动设备或个人电脑要求一次即刻虚拟诊断或预约。
Get a second, third, or tenth opinion from doctors in more than 105 specialties without waiting weeks for an appointment	从免等待的从105位专业医生中挑选的预约
Be in close touch about the health issues that concern you most	仔细关注令您最关心的健康问题
All of this for an affordable, per-consult fee. To get started, invite your doctors to HealthTap Concierge, and begin feeling good today!	所有这些都价格实惠，每次咨询费。作为开始，要求您的医生来HealthTap并从今天起开始享受健康！
Now your own personal doctors are just a HealthTap away. With the new HealthTap Concierge, connect directly with 	现在您的个人医生仅有一个HealthTap之遥。使用新的HealthTap，直接联系 
First: see if your doctors are already using HealthTap Concierge. If not, we’ll help get them on board. Simply provide us their contact information, and we’ll take care of the rest.	第一步：看您的医生是否使用HealthTap如果没有，我们会帮助他加入。仅仅告知我们他们的联系方式，我们会做余下的。
Once your doctor joins HealthTap Concierge, you’ll receive a unique Concierge Keycode to access your doctor’s virtual office hours.	您的医生一旦加入HealthTap Concierge，您会收到一份独一无二的您医生虚拟办公室的邀请码。
Are you looking for a new way to find and meet the perfect doctor for you? HealthTap Concierge can help. Picking the right doctor is a decision that’s too important to leave to chance.	您还在寻找找到适合您的完美医生的新方法吗？HealthTap Concierge可以提供帮助。找到一个正确的医生是一件极其重要的事情不能留给概率。
Thank you for helping others as a member of ClubMD.	谢谢您作为一名ClubMD对他人的帮助。
Your Answers	您的解答
Answers authored	授权解答
Your Agrees	您的同意
Agrees Made	同意
Your Network	您的网络
Colleagues added	同事添加的
Add Doctors	添加医生
Your Directory	您的目录
Invitations send	发送邀请
Invite patients	邀请患者
As a valued member of ClubMD you have the privilege of directly influencing the quality of health information millions access everywhere.	作为一名珍贵的ClubMD您有直接影响各地接收的健康信息质量的特权。
Maintain your ClubMD membership	维护您的ClubMD会员资格
We are excited that you've joined HealthTap Prime! This is one membership that will keep	我们很高兴您加入了HealthTap Prime！这是一个持续的会员资格
you healthy and happy all year long. In the next few weeks, we will send you a Welcome Box	您健康快乐一整年在接下来的数周内，我们会向您发送一个欢迎盒子。
that will show you how delighted we are that you've become a HealthTap Prime member.	我们对于您能成为一位HealthTap Prime黄金会员十分高兴
Please tap on the button to fill out a form so we can ship it to your home!	请点击按钮以完成一个表格这样我们能送到您家！
Started:	开始：
Progress:	过程：
Finished:	结束：
Duration:	期间：
Emails sent:	发送邮件：
Number of errors:	错误代码：
Welcome to the HealthTap Prime Strategic Advisor program! With HealthTap, you're offering a solution at the forefront of digital health by providing affordable, world-class healthcare to your clients. You're also making a smart business decision by earning 25% or more in commissions on your HealthTap sales.	欢迎来到HealthTap黄金战略咨询项目！使用HealthTap，您就站在了为您的客户提供可承受的、世界一流的医疗关怀的电子健康领域前沿。你正在使用您的HealthTap销售挣到25%或更多的佣金，这是个明智的商业决定。
Get started today—it's fast and easy. I recommend	立即开始 - 它快速且容易。我推荐
setting up a quick call	设置快速呼叫
with our Strategic Advisor Support Team, who will answer questions and provide you with compelling	有了完美的可提供服务和解答疑惑的战略咨询支持团队，
marketing materials	为您提供有吸引力的营销材料
to distribute to your clients.	分发给您的客户。
If you’re ready now to set up the selling price and group size for your clients,	如果您已经准备好为您的顾客建立售卖价格和群组大小
click here to get started.	点击这里获得更多&gt;
We look forward to a successful collaboration! If you have any questions, call our Strategic Advisor Support Team at	我们期待着一次成功的合作！如果您有任何问题，请联系我们的战略咨询支持团队
or email us at	或发送邮件到
Advisor@healthtap.com.	Advisor@healthtap.com.
Gary Robinson	Gary Robinson
You can check it out on the admin tool:	您可以在管理工具上查看：
enter your information and get access to your account ›	输入您的信息并访问您的帐户 &gt;
HealthTap Prime is convenient and easy, offering you:	HealthTap Prime方便快捷，为您提供：
We look forward to providing your group members access to their HealthTap Compass account.	我们期待提供给您的小组成员提供HealthTap ComPass账户
To do so, simply input or upload their information	要这样做，只需输入或上传他们的信息
here ›.	这里 ›.
Please use a personal computer and not a mobile	请使用个人计算机，而不是手机
or tablet to access this page as it will be more convenient to input or upload your group information.	将网页表格化可以使您的小组信息方便添加或上传。
Great news!	好消息！
HealthTap is bringing	HealthTap正在带来
you an award-winning virtual healthcare solution that instantly connects you with top U.S. licensed doctors for 24/7 care—all from any mobile device or computer.	一项获奖的可以使用任何移动设备或电脑的将您与美国顶尖持证医生即刻联系的虚拟医疗保健方案。
enter your information here ›.	在这里输入您的信息 ›.
HealthTap Prime is convenient and easy,  offering you:	HealthTap Prime方便快捷，为您提供：
With more than	与超过
40,000	40,000
HealthTap's all-new AppRx is bringing together	HealthTap全新AppRox正在汇集成
tens of thousands of the world's leading doctors	千上万的世界领先医生
to:	到:
the most helpful and useful apps for you	对您最有用的和最有帮助的应用程序
Categorize	分类
health apps to make them easy to discover	健康应用程序，使它们很容易被发现
An app was submitted with following details:	提交的应用程序包含以下详细信息：
There are several reasons that apps may not be listed in the directory, including:	有几个原因软件没有被列在目录中，包括：
The app is not designed for doctors or consumers	该应用程序不是为医生或消费者设计的
The app is in a foreign language	该应用程序使用其他语言
The app is primarily commercial (i.e. the app is a sales portal)	该应用程序主要用于商业（即该应用程序是一个销售门户）
The app contains inappropriate content (i.e. the app promotes violence)	该应用程序包含不当内容（即应用宣传暴力内容）
The app has too few ratings, or ratings that are low	该应用程式的评分很少，或评分太低
If you would like us to re-review your submission, please send an email with all relevant informaiton and the basis for your re-review request to 	如果您希望我们复查您的提交，请附带所有相关信息和您的复查申请给我们发邮件 
To your health,	为您的健康，
App Rating Feedback	应用程序评分反馈
User ID:	用户ID：
User Type:	用户类型：
App Version	应用程序版本
Source	来源
Doctors will now have the ability to recommend this app, bringing it to the attention of millions of people around the world!	医生们现在有推荐这款软件并吸引世界各地的人的能力！
Thanks for making the world a healthier, happier place one app at a time,	谢谢一度在这个软件上让世界变得更健康快乐，
Your answer continues to help others in need!	您的解答继续帮助有需要的人！
found one of your answers to be helpful enough to share with another patient who asked:	使您的答案对另一个患者有益
Attract more followers and grow your network by providing meaningful and trustworthy information within your areas of expertise.	通过提高您专业领域内的有意义值得信赖的信息来吸引更多的受众并发展您的网络。
1)	1)
2)	2)
3)	3)
Welcome to the HealthTap Compass Strategic Affiliate Advisor Program!	欢迎加入HealthTap战略附属咨询项目！
simple, streamlined process for your clients to start experiencing and enjoying HealthTap Compass.	为您的顾客准备的简单、流水线式的过程使他们享受体验HealthTap。
We are incredibly excited to offer you a 	我们非常高兴能为您提供 
Our Strategic Affiliate Advisor Support Team is ready to help you grow your business	我们的战略附属咨询支持团队准备好帮助您发展您的事业
immediately. Our	立刻我们
includes presentation decks, demo videos,	包括演示平台，演示视频，
and other marketing materials to help you succeed.	和其他营销材料，以帮助您获得成功。
Additionally, you can share the	此外，您可以
page with your clients.	与您的客户共享页面。
You can also use these credentials (login:	您还可以使用这些凭证（登录：
janesmith+brokerdemo	janesmith+brokerdemo
pw: healthtap1)	密码：healthtap1
to access an exclusive HealthTap Compass user account for live demonstration purposes. Your clients will love this!	获得一个专有的HealthTap用户账户来获得生动的论证目的。您的客户会喜欢这个！
When you’re ready to formalize your client’s enrollment in the HealthTap Compass service, please follow the steps below:	如果您准备好在HealthTap上形式化您的顾客登记，请参照以下步骤：
We look forward to a successful collaboration! If you have any questions, please don’t	我们期待着一次成功的合作！如果您有任何问题，请不要
hesitate to call our Strategic Advisor Support Team at	犹豫，请致电我们的战略顾问支持团队
affiliateht@healthtap.com.	affiliateht@healthtap.com.
HTID	HTID
Current package	当前套餐
Future package	未来套餐
Previous package	先前套餐
New package	新的套餐
Date of future change	未来更改日期
After setting up your password, to access your account visit:	在设置完您的密码之后，进入您的账户访问：
This account is deactivated from healthtap.	healthtap已停用您的账户。
Your HealthTap account has been deactivated. We are sorry to see you go and would love to hear more about your reasons for leaving so that we can better serve our members. If you have a moment, please respond to this email and share your feedback.	您的HealthTap帐户已停用。我们很遗憾您离开了但是希望知道您离开的理由以便我们能更好地服务我们的会员。如果您有时间，请回复这封邮件分享您的反馈。
Thank you.	谢谢
When you join HealthTap’s Medical Expert Network you will:	当您加入HealthTap的医疗专家系统您会：
Grow your practice with new patients	增加与新患者的实践
Distinguish yourself as an expert in your specialty	通过作为您专业领域的专家来区别您自己
Control your online reputation	管理您的线上声誉
Give your patients access to the information they need from a source they can trust you.	给您的顾客来自他们能信任的来源的信息。
